year,title,binary,budget,domgross,intgross,totalgross
2013,21 &amp; Over,FAIL,13000000,25682380,42195766,67878146
2012,Dredd 3D,PASS,45000000,13414714,40868994,54283708
2013,12 Years a Slave,FAIL,20000000,53107035,158607035,211714070
2013,2 Guns,FAIL,61000000,75612460,132493015,208105475
2013,42,FAIL,40000000,95020213,95020213,190040426
2013,47 Ronin,FAIL,225000000,38362475,145803842,184166317
2013,A Good Day to Die Hard,FAIL,92000000,67349198,304249198,371598396
2013,About Time,PASS,12000000,15323921,87324746,102648667
2013,Admission,PASS,13000000,18007317,18007317,36014634
2013,After Earth,FAIL,130000000,60522097,244373198,304895295
2013,American Hustle,PASS,40000000,148430908,249484909,397915817
2013,August: Osage County,PASS,25000000,37304874,50304874,87609748
2013,Beautiful Creatures,PASS,50000000,19452138,55940671,75392809
2013,Blue Jasmine,PASS,18000000,33345833,68447831,101793664
2013,Captain Phillips,FAIL,55000000,107136417,218743570,325879987
2013,Carrie,PASS,30000000,35266619,85001659,120268278
2013,Cloudy with a Chance of Meatballs 2,FAIL,78000000,119640264,271725448,391365712
2013,Despicable Me 2,PASS,76000000,368065385,970766005,1338831390
2013,Don Jon,FAIL,5500000,24477704,26377704,50855408
2013,Elysium,PASS,120000000,93050117,286192091,379242208
2013,Ender&#39;s Game,FAIL,110000000,61737191,89737191,151474382
2013,Epic,PASS,100000000,107518682,268418682,375937364
2013,Escape from Planet Earth,PASS,40000000,57012977,66454811,123467788
2013,Escape Plan,FAIL,70000000,25213103,103813103,129026206
2013,Evil Dead,PASS,17000000,54239856,97402049,151641905
2013,Fast and Furious 6,PASS,160000000,238679850,788128122,1026807972
2013,Frozen,PASS,150000000,393050114,1004550114,1397600228
2013,G.I. Joe: Retaliation,PASS,140000000,122523060,371923060,494446120
2013,Gangster Squad,FAIL,60000000,46000903,104100903,150101806
2013,Gloria,PASS,30000000,4167493,4967493,9134986
2013,Gravity,FAIL,110000000,271814796,708714796,980529592
2013,Grown Ups 2,FAIL,80000000,133668525,247023808,380692333
2013,Hansel &amp; Gretel: Witch Hunters,PASS,50000000,55703475,225703475,281406950
2013,Her,FAIL,23000000,25000178,33029713,58029891
2013,Identity Thief,FAIL,35000000,134506920,176269721,310776641
2013,Insidious: Chapter 2,FAIL,5000000,83586447,161911222,245497669
2013,Iron Man 3,FAIL,200000000,408992272,1212692272,1621684544
2013,Jack the Giant Slayer,FAIL,195000000,65187603,197387603,262575206
2013,Kick-Ass 2,PASS,28000000,28795985,60839197,89635182
2013,Last Vegas,FAIL,28000000,63914167,112914167,176828334
2013,Lee Daniels&#39; The Butler,PASS,30000000,116632095,151513429,268145524
2013,Machete Kills,PASS,2000000,8008161,9408161,17416322
2013,Mama,PASS,15000000,71628180,148041253,219669433
2013,Man of Steel,PASS,225000000,291045518,687999518,979045036
2013,Nebraska,PASS,12000000,17482517,17482517,34965034
2013,Now You See Me,FAIL,75000000,117723989,351723989,469447978
2013,Oblivion,FAIL,120000000,89107235,287537983,376645218
2013,Olympus Has Fallen,FAIL,70000000,98927592,150562164,249489756
2013,Oz the Great and Powerful,PASS,200000000,234770996,489570996,724341992
2013,Pacific Rim,FAIL,190000000,101802906,411002906,512805812
2013,Pain &amp; Gain,FAIL,26000000,49875291,81275291,131150582
2013,Parker,PASS,35000000,17616641,46346651,63963292
2013,Peeples,FAIL,15000000,9177065,9177065,18354130
2013,Percy Jackson: Sea of Monsters,PASS,90000000,68559554,200859554,269419108
2013,Prisoners,PASS,46000000,61002302,113402302,174404604
2013,R.I.P.D.,FAIL,130000000,33618855,79019947,112638802
2013,Red 2,PASS,84000000,53262560,137162560,190425120
2013,Riddick,FAIL,38000000,42025135,92425135,134450270
2013,Runner Runner,FAIL,30000000,19316646,62616646,81933292
2013,Rush,FAIL,38000000,26947624,43047624,69995248
2013,Safe Haven,PASS,28000000,71399120,93943623,165342743
2013,Saving Mr. Banks,PASS,35000000,82834332,100734332,183568664
2013,Side Effects,PASS,30000000,32172757,60288363,92461120
2013,Star Trek Into Darkness,FAIL,190000000,228778661,466978661,695757322
2013,Texas Chainsaw 3D,PASS,20000000,34341945,39093317,73435262
2013,The Big Wedding,PASS,32500000,21819348,35770721,57590069
2013,The Book Thief,PASS,19000000,21345525,62045525,83391050
2013,The Call,PASS,13000000,51872378,58938768,110811146
2013,The Conjuring,PASS,20000000,137400141,318000141,455400282
2013,The Counselor,PASS,25000000,16973715,70373715,87347430
2013,The Croods,FAIL,135000000,187168425,573068425,760236850
2013,The Family,FAIL,30000000,36918811,51078541,87997352
2013,The Fifth Estate,FAIL,26000000,3254172,6154172,9408344
2013,The Frozen Ground,FAIL,19200000,N/A,N/A,#VALUE!
2013,The Great Gatsby,FAIL,190000000,144840419,351040419,495880838
2013,The Hangover part 3,FAIL,103000000,112200072,362000072,474200144
2013,The Heat,PASS,43000000,159581587,230781587,390363174
2013,The Hobbit: The Desolation of Smaug,FAIL,250000000,257397516,937397516,1194795032
2013,The Host,FAIL,50000000,26623701,58188384,84812085
2013,The Hunger Games: Catching Fire,PASS,130000000,424088260,857088260,1281176520
2013,The Incredible Burt Wonderstone,FAIL,32000000,22537881,24255957,46793838
2013,The Internship,FAIL,58000000,44672764,93672764,138345528
2013,The Last Exorcism Part II,PASS,4000000,15179303,18541236,33720539
2013,The Lone Ranger,FAIL,275000000,89289910,259989910,349279820
2013,The Mortal Instruments: City of Bones,PASS,60000000,31165421,75965567,107130988
2013,The Purge,FAIL,3000000,64473115,91100541,155573656
2013,The Smurfs 2,PASS,110000000,71017784,348545841,419563625
2013,The To Do List,PASS,1500000,3491669,3491669,6983338
2013,The Way Way Back,PASS,5000000,21502690,26161443,47664133
2013,The Wolf of Wall Street,FAIL,100000000,115702857,365702857,481405714
2013,The Wolverine,PASS,115000000,132556852,416456852,549013704
2013,The World&#39;s End,FAIL,20000000,26004851,46578821,72583672
2013,This Is the End,FAIL,32000000,101470202,126294264,227764466
2013,Thor: The Dark World,FAIL,170000000,204674790,631674790,836349580
2013,Trance,FAIL,16000000,2322593,22594052,24916645
2013,Turbo,FAIL,135000000,83028130,283828130,366856260
2013,Warm Bodies,FAIL,30000000,66380662,116643610,183024272
2013,We&#39;re the Millers,PASS,37000000,150394119,270000119,420394238
2013,White House Down,FAIL,150000000,73103784,205440387,278544171
2013,World War Z,FAIL,190000000,202359711,539559711,741919422
2012,Abraham Lincoln: Vampire Hunter,FAIL,67500000,37519139,115119139,152638278
2012,Act of Valor,FAIL,12000000,70012847,82497035,152509882
2012,Amour,FAIL,9700000,6738954,25915719,32654673
2012,Anna Karenina,FAIL,49000000,12816367,70735540,83551907
2012,Argo,PASS,44500000,136025503,221300694,357326197
2012,Battleship,FAIL,209000000,65235400,304142720,369378120
2012,Beasts of the Southern Wild,FAIL,1800000,12795746,21080058,33875804
2012,Blue Like Jazz,PASS,1200000,595018,595018,1190036
2012,Brave,PASS,185000000,237282182,554606532,791888714
2012,Bullet to the Head,FAIL,55000000,9489829,13561515,23051344
2012,Chernobyl Diaries,FAIL,1000000,18119640,38390020,56509660
2012,Chronicle,FAIL,12000000,64575175,127075175,191650350
2012,Cloud Atlas,PASS,102000000,27108272,126018564,153126836
2012,Contraband,PASS,25000000,66528000,98406855,164934855
2012,Django Unchained,FAIL,100000000,162805434,425373688,588179122
2012,Flight,FAIL,31000000,93772375,161772375,255544750
2012,Frankenweenie,FAIL,39000000,35287788,81150788,116438576
2012,Hannibal,PASS,87000000,165092266,350100280,515192546
2012,Hotel Transylvania,PASS,85000000,148313048,359222014,507535062
2012,Jack Reacher,FAIL,60000000,80070736,217370736,297441472
2012,Jagten,FAIL,3450000,687185,687185,1374370
2012,John Carter,PASS,275000000,73058679,282778100,355836779
2012,Killing Them Softly,FAIL,15000000,14945541,37238774,52184315
2012,Les Miserables,PASS,65000000,148809770,442022894,590832664
2012,Life of Pi,FAIL,120000000,124987022,607987022,732974044
2012,Lincoln,PASS,65000000,182207973,273000960,455208933
2012,Madagascar 3: Europe&#39;s Most Wanted,FAIL,145000000,216391482,746921271,963312753
2012,Men in Black III,FAIL,215000000,179020854,624821154,803842008
2012,Mirror Mirror,FAIL,85000000,64935167,168611991,233547158
2012,Moonrise Kingdom,PASS,16000000,45512466,64012466,109524932
2012,Much Ado About Nothing,FAIL,8000000,22549338,22549338,45098676
2012,One for the Money,PASS,42000000,26414527,36197221,62611748
2012,Paranormal Activity 4,PASS,5000000,53900335,142793842,196694177
2012,ParaNorman,FAIL,60000000,56003051,108159011,164162062
2012,Parental Guidance,PASS,25000000,77267296,120168633,197435929
2012,People Like Us,PASS,16000000,12431792,12431792,24863584
2012,Pitch Perfect,PASS,17000000,65001093,115331177,180332270
2012,Premium Rush,PASS,35000000,20275446,31393201,51668647
2012,Red Dawn,FAIL,65000000,44806783,48164150,92970933
2012,Red Tails,FAIL,58000000,49876377,50365498,100241875
2012,Rise of the Guardians,FAIL,145000000,103412758,306900902,410313660
2012,Rock of Ages,PASS,70000000,38518613,50118613,88637226
2012,Safe,FAIL,33000000,17142080,41495213,58637293
2012,Safety Not Guaranteed,PASS,750000,4010957,4413188,8424145
2012,Seven Psychopaths,FAIL,13500000,15024049,23492318,38516367
2012,Silent Hill: Revelation 3D,PASS,20000000,17530219,47944599,65474818
2012,Silver Linings Playbook,PASS,21000000,132092958,227317397,359410355
2012,Sinister,FAIL,3000000,48086903,87727807,135814710
2012,Skyfall,FAIL,200000000,304360277,1108694081,1413054358
2012,Snow White and the Huntsman,PASS,170000000,155136755,400911200,556047955
2012,Sparkle,PASS,10000000,24397469,24660323,49057792
2012,Spring Breakers,PASS,5000000,14124286,30669531,44793817
2012,Step Up Revolution,PASS,33000000,35074677,165552290,200626967
2012,Supporting Characters,FAIL,60000,4917,4917,9834
2012,Ted,FAIL,50000000,218665740,549444574,768110314
2012,That&#39;s My Boy,FAIL,67500000,36931089,58058367,94989456
2012,The Amazing Spider-Man,FAIL,220000000,262030663,757890267,1019920930
2012,The Avengers,FAIL,60000000,23385416,48585416,71970832
2012,The Dark Knight Rises,FAIL,275000000,448139099,1079343943,1527483042
2012,The Devil Inside,PASS,1000000,53261944,101758489,155020433
2012,The Dictator,FAIL,65000000,59650222,179379532,239029754
2012,The Expendables 2,PASS,100000000,85028192,311979256,397007448
2012,The Grey,FAIL,25000000,51580136,84339696,135919832
2012,The Hobbit: An Unexpected Journey,FAIL,250000000,303003568,1014703568,1317707136
2012,The Hunger Games,PASS,80000000,408010692,684510692,1092521384
2012,The Impossible,FAIL,40000000,19019882,169590606,188610488
2012,The Man with the Iron Fists,FAIL,15000000,15634090,21985095,37619185
2012,The Master,FAIL,37500000,16247159,25116740,41363899
2012,The Pirates! Band of Misfits,FAIL,55000000,31051126,123056220,154107346
2012,The Place Beyond the Pines,FAIL,15000000,21403519,47011449,68414968
2012,The Twilight Saga: Breaking Dawn - Part 2,FAIL,136200000,292324737,832660037,1124984774
2012,The Vow,PASS,8738320,125014030,197618160,322632190
2012,The Watch,FAIL,55000000,34353000,67353000,101706000
2012,The Woman in Black,FAIL,15000000,54333290,128955898,183289188
2012,The Words,FAIL,6000000,11494838,12132578,23627416
2012,Think Like a Man,PASS,12000000,91547205,96155124,187702329
2012,To Rome With Love,FAIL,21500000,16684352,74363777,91048129
2012,Total Recall,FAIL,125000000,58877969,198615996,257493965
2012,Underworld: Awakening,PASS,70000000,62321039,160379930,222700969
2012,Wanderlust,PASS,32500000,17288155,24159934,41448089
2012,What to Expect When You&#39;re Expecting,PASS,37500000,41152203,80652203,121804406
2012,Won&#39;t Back Down,PASS,19000000,5310554,5431486,10742040
2012,Wrath of the Titans,FAIL,150000000,83670083,301970083,385640166
2012,Wreck-It Ralph,PASS,165000000,189412677,473412677,662825354
2012,Zero Dark Thirty,PASS,52500000,95720716,137720716,233441432
2011,30 Minutes or Less,FAIL,28000000,37053924,40966716,78020640
2011,50/50,FAIL,8000000,35016118,41334735,76350853
2011,A Dangerous Method,FAIL,20000000,5702083,14807531,20509614
2011,A Lonely Place to Die,PASS,4000000,N/A,442550,#VALUE!
2011,A Very Harold &amp; Kumar 3D Christmas,FAIL,20000000,35061031,36265745,71326776
2011,Another Earth,PASS,175000,1321194,1781194,3102388
2011,Apollo 18,FAIL,5000000,17686929,26517819,44204748
2011,Arthur Christmas,FAIL,85000000,46462469,147624649,194087118
2011,Attack the Block,PASS,13000000,1024175,5406422,6430597
2011,Bad Teacher,PASS,19000000,100292856,216412265,316705121
2011,Battle: Los Angeles,FAIL,70000000,83552429,212005201,295557630
2011,Beastly,FAIL,17000000,27865571,38028230,65893801
2011,Blackthorn,FAIL,4500000,200558,1249765,1450323
2011,Bridesmaids,PASS,32500000,169106725,289263136,458369861
2011,Captain America: The First Avenger,FAIL,140000000,176654505,370569776,547224281
2011,Cars 2,FAIL,200000000,191450875,560155383,751606258
2011,Circumstance,PASS,900000,454121,454121,908242
2011,Colombiana,FAIL,40000000,36665854,71698079,108363933
2011,Conan the Barbarian,FAIL,20000000,38264085,79114085,117378170
2011,Contagion,PASS,60000000,75658097,137551594,213209691
2011,Coriolanus,FAIL,10000000,749641,1049641,1799282
2011,Cowboys &amp; Aliens,FAIL,163000000,100240551,175910315,276150866
2011,Detention,PASS,10000000,N/A,N/A,#VALUE!
2011,Diary of a Wimpy Kid: Rodrick Rules,FAIL,18000000,52698535,73695194,126393729
2011,Dolphin Tale,FAIL,37000000,72286779,96068724,168355503
2011,Dream House,PASS,50000000,21302340,39932340,61234680
2011,Drive,FAIL,15000000,35060689,78054825,113115514
2011,Fast Five,PASS,125000000,209837675,629841284,839678959
2011,Final Destination 5,FAIL,40000000,42587643,157887643,200475286
2011,Footloose,PASS,24000000,51802742,63412773,115215515
2011,Fright Night,FAIL,30000000,18298649,40520649,58819298
2011,Green Lantern,FAIL,200000000,116601172,231201172,347802344
2011,Hall Pass,FAIL,36000000,45060734,83693266,128754000
2011,Hanna,PASS,30000000,40259119,65343694,105602813
2011,Harry Potter and the Deathly Hallows: Part 2,FAIL,125000000,381011219,1328111219,1709122438
2011,Haywire,FAIL,23000000,18942396,22176190,41118586
2011,Hesher,FAIL,7000000,382946,382946,765892
2011,Higher Ground,PASS,1800000,841056,859182,1700238
2011,Hobo with a Shotgun,FAIL,3000000,703372,834953,1538325
2011,Hop,FAIL,63000000,108085305,184924333,293009638
2011,Horrible Bosses,PASS,35000000,117538559,214538559,332077118
2011,Hugo,FAIL,180000000,73864507,185033215,258897722
2011,I Am Number Four,FAIL,50000000,55100437,145982797,201083234
2011,Immortals,FAIL,75000000,83504017,211562435,295066452
2011,In Time,FAIL,35000000,37553932,170064664,207618596
2011,Iris,PASS,5500000,5580479,15155021,20735500
2011,Jin ling shi san chai,PASS,100000000,311434,93721434,94032868
2011,Johnny English Reborn,FAIL,45000000,8305970,164539660,172845630
2011,Jumping the Broom,PASS,7000000,37295394,38158601,75453995
2011,Just Go with It,FAIL,80000000,103028109,214974953,318003062
2011,Kill List,FAIL,800000,29063,462206,491269
2011,Killer Elite,FAIL,70000000,25124986,57777106,82902092
2011,Kung Fu Panda 2,PASS,150000000,165249063,664837547,830086610
2011,Le Havre,FAIL,5500000,611709,13480196,14091905
2011,Like Crazy,PASS,250000,3395391,3731489,7126880
2011,Limitless,FAIL,27000000,79249455,169739455,248988910
2011,Margaret,PASS,14000000,47185,47185,94370
2011,Margin Call,FAIL,3400000,5353586,17872206,23225792
2011,Mars Needs Moms,FAIL,150000000,21392758,39549758,60942516
2011,Martha Marcy May Marlene,PASS,1000000,2981038,3531038,6512076
2011,Melancholia,PASS,9400000,3030848,18044073,21074921
2011,Midnight in Paris,PASS,30000000,56816662,154816662,211633324
2011,Mission: Impossible - Ghost Protocol,FAIL,145000000,209397903,694713230,904111133
2011,Moneyball,FAIL,50000000,75605492,111174374,186779866
2011,Mr. Popper&#39;s Penguins,FAIL,55000000,68224452,189624452,257848904
2011,New Year&#39;s Eve,PASS,26000000,54544638,143663899,198208537
2011,No Strings Attached,PASS,25000000,70662220,149228078,219890298
2011,October Baby,PASS,1000000,5355847,5355847,10711694
2011,Our Idiot Brother,PASS,5000000,24814830,25861249,50676079
2011,Paranormal Activity 3,PASS,5000000,104028807,207039844,311068651
2011,Paul,PASS,40000000,37412945,100179814,137592759
2011,Pirates of the Caribbean: On Stranger Tides,FAIL,250000000,241063875,1043663875,1284727750
2011,Priest,FAIL,60000000,29136626,84154026,113290652
2011,Puss in Boots,FAIL,130000000,149260504,554987477,704247981
2011,Rango,FAIL,135000000,123257581,245504574,368762155
2011,Real Steel,FAIL,110000000,85463309,293237309,378700618
2011,Red Riding Hood,PASS,42000000,37662162,90300442,127962604
2011,Red State,PASS,4000000,1065429,1065429,2130858
2011,Restless,PASS,8000000,163753,2818394,2982147
2011,Rio,FAIL,90000000,143619809,487519809,631139618
2011,Rise of the Planet of the Apes,FAIL,93000000,176760185,482860185,659620370
2011,Shame,FAIL,6500000,4002293,10781688,14783981
2011,Snow Flower and the Secret Fan,PASS,6000000,1348205,11348205,12696410
2011,Soul Surfer,PASS,18000000,43853424,47158652,91012076
2011,Source Code,FAIL,32000000,54712227,140428499,195140726
2011,Straw Dogs,PASS,25000000,10324441,11253821,21578262
2011,Sucker Punch,PASS,75000000,36392502,89758389,126150891
2011,Super 8,PASS,50000000,127004179,260095987,387100166
2011,Take Shelter,PASS,4750000,1728953,3128953,4857906
2011,The Adjustment Bureau,FAIL,50200000,62495645,127793502,190289147
2011,The Adventures of Tintin,FAIL,130000000,77591831,373993951,451585782
2011,The Artist,FAIL,16000000,44667095,128256712,172923807
2011,The Best Exotic Marigold Hotel,PASS,10000000,46383639,134729347,181112986
2011,The Cabin in the Woods,FAIL,30000000,42073277,70768144,112841421
2011,The Darkest Hour,PASS,34800000,21443494,62831715,84275209
2011,The Divide,PASS,3000000,18000,18000,36000
2011,The Future,PASS,1000000,568662,568662,1137324
2011,The Girl with the Dragon Tattoo,FAIL,90000000,102515793,233170238,335686031
2011,The Green Hornet,FAIL,110000000,98780042,227983150,326763192
2011,The Guard,FAIL,6000000,5359774,15944629,21304403
2011,The Help,PASS,25000000,169705587,213120004,382825591
2011,The Iron Lady,PASS,14000000,29959436,115592104,145551540
2011,The Lincoln Lawyer,FAIL,40000000,58009200,87145086,145154286
2011,The Mechanic,FAIL,42500000,29121498,76347393,105468891
2011,The Muppets,FAIL,45000000,88625922,160971922,249597844
2011,The Rite,FAIL,37000000,33047633,96047633,129095266
2011,The Roommate,PASS,16000000,37300107,40497461,77797568
2011,The Smurfs,PASS,110000000,142614158,563066551,705680709
2011,The Three Musketeers,FAIL,90000000,20377913,139877913,160255826
2011,The Tree of Life,FAIL,35000000,13305665,62305665,75611330
2011,The Twilight Saga: Breaking Dawn - Part 1,PASS,127500000,281287133,709938657,991225790
2011,Thor,PASS,150000000,181030624,449326618,630357242
2011,Tinker Tailor Soldier Spy,FAIL,21000000,24149393,81452811,105602204
2011,Tower Heist,FAIL,85000000,78046570,153470352,231516922
2011,Transformers: Dark of the Moon,PASS,195000000,352390543,1123794076,1476184619
2011,War Horse,FAIL,70000000,79883359,156815529,236698888
2011,Warrior,FAIL,25000000,13657115,24215385,37872500
2011,We Bought a Zoo,FAIL,50000000,75624550,118924550,194549100
2011,Weekend,FAIL,190000,484592,1577585,2062177
2011,What&#39;s Your Number,PASS,20000000,14011084,30711084,44722168
2011,Winnie the Pooh,FAIL,30000000,26692846,50145607,76838453
2011,X-Men: First Class,PASS,160000000,146408305,355408305,501816610
2011,Young Adult,PASS,12000000,16311571,22750356,39061927
2011,Your Sister&#39;s Sister,PASS,120000,1597486,3090593,4688079
2010,127 Hours,FAIL,18000000,18335230,60735230,79070460
2010,Alice in Wonderland,PASS,200000000,334191110,1024391110,1358582220
2010,Animal Kingdom,FAIL,4200000,1044039,8078683,9122722
2010,Another Year,PASS,8000000,3205706,18505706,21711412
2010,Barney&#39;s Version,PASS,30000000,7502560,8845575,16348135
2010,Beginners,FAIL,3200000,5790894,11564267,17355161
2010,Biutiful,FAIL,35000000,5101237,25101237,30202474
2010,Black Swan,PASS,13000000,106954678,331266710,438221388
2010,Blue Valentine,FAIL,1000000,9737892,16566240,26304132
2010,Burlesque,PASS,55000000,39440655,89657398,129098053
2010,Casino Jack,FAIL,12500000,2039869,2080869,4120738
2010,Centurion,FAIL,15000000,123570,6623570,6747140
2010,Charlie St. Cloud,FAIL,44000000,31206263,48478084,79684347
2010,Clash of the Titans,FAIL,125000000,163214888,493214888,656429776
2010,Conviction,PASS,12500000,6797696,10133552,16931248
2010,Cop Out,FAIL,37000000,44875481,55909910,100785391
2010,Country Strong,PASS,15000000,20218921,20551476,40770397
2010,Cyrus,FAIL,7000000,7468936,10039886,17508822
2010,Date Night,PASS,55000000,98711404,152269033,250980437
2010,Dear John,FAIL,25000000,80014842,111362410,191377252
2010,Despicable Me,PASS,69000000,251513985,543495033,795009018
2010,Devil,PASS,10000000,33679655,63354114,97033769
2010,Diary of a Wimpy Kid,PASS,15000000,64003625,76954311,140957936
2010,Dinner for Schmucks,FAIL,69000000,73026337,86796502,159822839
2010,Don&#39;t Be Afraid of the Dark,PASS,25000000,24046682,31551048,55597730
2010,Due Date,FAIL,65000000,100539043,211739043,312278086
2010,Dylan Dog: Dead of Night,FAIL,20000000,1186538,6090697,7277235
2010,Easy A,PASS,8000000,58401464,76200721,134602185
2010,"Eat, Pray, Love",PASS,60000000,80574010,205846861,286420871
2010,Edge of Darkness,FAIL,60000000,43313890,81208697,124522587
2010,Everything Must Go,FAIL,5000000,2712131,2712131,5424262
2010,Fair Game,PASS,50000000,11497497,26097497,37594994
2010,Faster,FAIL,12000000,23240020,35658648,58898668
2010,For Colored Girls,PASS,21000000,37729698,38017873,75747571
2010,Frozen,FAIL,150000000,393050114,1004550114,1397600228
2010,Get Him To The Greek,FAIL,40000000,61153526,91455875,152609401
2010,Going the Distance,PASS,32000000,17804299,39990165,57794464
2010,Green Zone,FAIL,100000000,35497337,97523020,133020357
2010,Grown Ups,PASS,75000000,162001186,272223430,434224616
2010,Gunless,FAIL,9900000,458054,458054,916108
2010,Harry Potter and the Deathly Hallows: Part 1,PASS,125000000,295983305,956399711,1252383016
2010,Hot Tub Time Machine,FAIL,36000000,50269859,63209958,113479817
2010,How to Train Your Dragon,PASS,165000000,217581231,494870991,712452222
2010,I Am Love,PASS,10000000,5005465,15132211,20137676
2010,Inception,FAIL,160000000,292576195,832584416,1125160611
2010,Insidious,PASS,1500000,54009150,99870886,153880036
2010,Iron Man 2,PASS,170000000,312433331,623561331,935994662
2010,It&#39;s Kind of a Funny Story,FAIL,8000000,6363628,6628326,12991954
2010,Kick-Ass,FAIL,28000000,48071303,97527535,145598838
2010,Knight and Day,FAIL,117000000,76423035,262142047,338565082
2010,Legion,PASS,26000000,40168080,68854097,109022177
2010,Let Me In,FAIL,20000000,12134935,28270399,40405334
2010,Letters to Juliet,FAIL,30000000,53032453,79135982,132168435
2010,Love and Other Drugs,FAIL,30000000,32367005,102719647,135086652
2010,Machete,PASS,12500000,26593646,44331957,70925603
2010,Made In Dagenham,PASS,8000000,1095369,15644196,16739565
2010,Meek&#39;s Cutoff,FAIL,2000000,977772,1869928,2847700
2010,Megamind,FAIL,130000000,148415853,321887208,470303061
2010,Monsters,FAIL,500000,237301,5639730,5877031
2010,Morning Glory,PASS,40000000,31011732,60040974,91052706
2010,Nanny McPhee and the Big Bang,PASS,35000000,29197642,97799865,126997507
2010,Never Let Me Go,PASS,15000000,2434652,11509512,13944164
2010,Paranormal Activity 2,PASS,3000000,84752907,177512032,262264939
2010,Percy Jackson &amp; the Olympians: The Lightning Thief,FAIL,95000000,88768303,226467130,315235433
2010,Please Give,PASS,3000000,4033574,4570178,8603752
2010,Predators,FAIL,40000000,52000688,127234389,179235077
2010,Prince of Persia: The Sands of Time,FAIL,200000000,90759676,335059676,425819352
2010,Rabbit Hole,PASS,5000000,2229058,5839592,8068650
2010,Ramona and Beezus,PASS,15000000,26167002,27469621,53636623
2010,Red,FAIL,60000000,90380162,196439693,286819855
2010,Remember Me,PASS,16000000,19068240,56506120,75574360
2010,Repo Men,PASS,32000000,13942007,18195238,32137245
2010,Robin Hood,FAIL,210000000,105487148,322459006,427946154
2010,Salt,PASS,130000000,118311368,295713467,414024835
2010,Scott Pilgrim vs. the World,PASS,85000000,31611316,48089760,79701076
2010,Secretariat,PASS,35000000,59699513,60376247,120075760
2010,Sex and the city 2,PASS,95000000,95347692,294680778,390028470
2010,Shrek Forever After,FAIL,165000000,238736787,756244673,994981460
2010,Shutter Island,FAIL,80000000,128012934,296831073,424844007
2010,Skyline,FAIL,10000000,21416355,78693371,100109726
2010,Somewhere,FAIL,7000000,1785645,14385645,16171290
2010,Submarine,FAIL,1900000,467602,4581937,5049539
2010,Super,FAIL,2500000,327716,518362,846078
2010,Takers,FAIL,32000000,57744720,70587268,128331988
2010,Tangled,PASS,260000000,200821936,586581936,787403872
2010,The A-Team,FAIL,110000000,77222099,177241171,254463270
2010,The Back-up Plan,PASS,35000000,37490007,75281179,112771186
2010,The Chronicles of Narnia: The Voyage of the Dawn Treader,PASS,155000000,104386950,418186950,522573900
2010,The Conspirator,FAIL,25000000,11538204,15907411,27445615
2010,The Crazies,PASS,19000000,39123589,54956140,94079729
2010,The Debt,PASS,20000000,31177548,46604054,77781602
2010,The Expendables,FAIL,82000000,103068524,268268174,371336698
2010,The Fighter,FAIL,11000000,93617009,129262388,222879397
2010,The Ghost Writer,FAIL,45000000,15541549,65532491,81074040
2010,The Illusionist,FAIL,16500000,39868642,83792062,123660704
2010,The Karate Kid,FAIL,40000000,176591618,359091618,535683236
2010,The Kids Are All Right,PASS,4000000,20811365,36275469,57086834
2010,The Killer Inside Me,FAIL,13000000,217277,3617277,3834554
2010,The King&#39;s Speech,PASS,15000000,138797449,430821166,569618615
2010,The Last Airbender,FAIL,150000000,131772187,319713881,451486068
2010,The Last Exorcism,PASS,1800000,41034350,70165900,111200250
2010,The Losers,FAIL,25000000,23591432,26714018,50305450
2010,The Next Three Days,PASS,30000000,21148651,67255916,88404567
2010,The Other Guys,FAIL,100000000,119219978,170936470,290156448
2010,The Runaways,PASS,9500000,3573673,5278632,8852305
2010,The Social Network,FAIL,40000000,96962694,224922135,321884829
2010,The Sorcerer&#39;s Apprentice,FAIL,160000000,63150991,215150991,278301982
2010,The Spy Next Door,PASS,28000000,24307106,50983364,75290470
2010,The Switch,FAIL,19000000,27758465,49858465,77616930
2010,The Tempest,PASS,20000000,277943,277943,555886
2010,The Tourist,FAIL,100000000,67631157,278731369,346362526
2010,The Town,FAIL,37000000,92186262,152566881,244753143
2010,The Twilight Saga: Eclipse,PASS,68000000,300531751,699590681,1000122432
2010,The Wolfman,FAIL,150000000,62189884,142634358,204824242
2010,Tiny Furniture,PASS,50000,391674,424149,815823
2010,Toy Story 3,FAIL,200000000,415004880,1063759456,1478764336
2010,Tron Legacy,FAIL,200000000,172062763,397562763,569625526
2010,True Grit,PASS,35000000,171243005,252276928,423519933
2010,Tucker and Dale vs Evil,PASS,5000000,223838,5476793,5700631
2010,Unstoppable,FAIL,95000000,81562942,169511609,251074551
2010,Valentine&#39;s Day,PASS,52000000,110485654,217569328,328054982
2010,Wall Street: Money Never Sleeps,FAIL,70000000,52474616,137431619,189906235
2010,Welcome to the Rileys,PASS,10000000,152857,312857,465714
2010,Wild Target,FAIL,8000000,109338,109338,218676
2010,Winter&#39;s Bone,PASS,2000000,6531503,16131552,22663055
2010,Womb,PASS,13000000,N/A,N/A,#VALUE!
2010,Yogi Bear,FAIL,80000000,100246011,202284317,302530328
2010,You Again,PASS,20000000,25702053,32838945,58540998
2010,You Will Meet a Tall Dark Stranger,PASS,15000000,3247816,34247816,37495632
2009,(500) Days of Summer,FAIL,7500000,32391374,60803210,93194584
2009,17 Again,PASS,40000000,64167069,139474906,203641975
2009,2012,FAIL,200000000,166112167,788408539,954520706
2009,9,FAIL,30000000,31749894,48559999,80309893
2009,A Perfect Getaway,FAIL,14000000,15515460,22815460,38330920
2009,A Serious Man,FAIL,7000000,9228788,30360570,39589358
2009,A Single Man,FAIL,7000000,9176000,28142379,37318379
2009,Adam,FAIL,3200000,2277396,2828590,5105986
2009,Adventureland,FAIL,9800000,16044025,17144025,33188050
2009,Agora,FAIL,70000000,619423,38992292,39611715
2009,Ajami,FAIL,1000000,621859,621859,1243718
2009,All About Steve,PASS,15000000,33862903,40127259,73990162
2009,An Education,PASS,7500000,12574914,29652736,42227650
2009,Angels &amp; Demons,FAIL,150000000,133375846,490875846,624251692
2009,Armored,FAIL,20000000,15988876,23661038,39649914
2009,Astro Boy,FAIL,65000000,19551067,44093014,63644081
2009,Avatar,FAIL,425000000,760507625,2783918982,3544426607
2009,Away We Go,PASS,21000000,9451946,10108016,19559962
2009,Br&uuml;no,FAIL,42000000,60054530,130788243,190842773
2009,Bride Wars,PASS,30000000,58715510,115150424,173865934
2009,Bright Star,PASS,8500000,4444637,17260680,21705317
2009,Brooklyn&#39;s Finest,FAIL,17000000,27163593,39233233,66396826
2009,Brothers,PASS,26000000,28544157,45043870,73588027
2009,Capitalism: A Love Story,FAIL,20000000,14363397,19121531,33484928
2009,Case 39,PASS,27000000,13261851,29302804,42564655
2009,Chloe,FAIL,13000000,3075255,9675172,12750427
2009,Cloudy with a Chance of Meatballs,FAIL,100000000,124870275,236827677,361697952
2009,Coco avant Chanel,PASS,23000000,6113834,50813834,56927668
2009,Coraline,PASS,60000000,75286229,126037057,201323286
2009,Daybreakers,FAIL,20000000,30101577,51401577,81503154
2009,Dead Snow,FAIL,800000,46742,2194020,2240762
2009,District 9,FAIL,30000000,115646235,215196627,330842862
2009,Drag Me to Hell,PASS,30000000,42100625,91388487,133489112
2009,Enter the Void,FAIL,16000000,337997,337997,675994
2009,Everybody&#39;s Fine,FAIL,20000000,9208876,9208876,18417752
2009,Fantastic Mr. Fox,FAIL,40000000,21002919,46498922,67501841
2009,Fast &amp; Furious,FAIL,85000000,155064265,363064265,518128530
2009,Fired Up!,FAIL,20000000,17231291,18608570,35839861
2009,Fish Tank,PASS,3000000,374675,5922292,6296967
2009,Friday the 13th,FAIL,17000000,65002019,91700771,156702790
2009,Funny People,FAIL,72500000,51855045,71880305,123735350
2009,G-Force,FAIL,150000000,119436770,287389685,406826455
2009,G.I. Joe: The Rise of Cobra,FAIL,175000000,150201498,302469017,452670515
2009,Gamer,FAIL,50000000,20534907,35062683,55597590
2009,Get Low,FAIL,7000000,9176933,9696933,18873866
2009,Harry Brown,FAIL,7300000,1818681,6294140,8112821
2009,Harry Potter and the Half-Blood Prince,PASS,250000000,301959197,934416487,1236375684
2009,He&#39;s Just Not That Into You,PASS,40000000,93953653,178390243,272343896
2009,I Come with the Rain,FAIL,18000000,0,627422,627422
2009,I Love You Phillip Morris,FAIL,13000000,2037459,15144685,17182144
2009,"I Love You, Man",FAIL,40000000,71440011,91729503,163169514
2009,Ice Age: Dawn of the Dinosaurs,FAIL,90000000,196573705,886968695,1083542400
2009,Inglourious Basterds,FAIL,70000000,120831050,316971720,437802770
2009,Invictus,FAIL,49000000,37491364,124491364,161982728
2009,It&#39;s Complicated,PASS,85000000,112735375,224614744,337350119
2009,Jennifer&#39;s Body,PASS,16000000,16204793,32832166,49036959
2009,Julie &amp; Julia,PASS,40000000,94125426,126646119,220771545
2009,Knowing,FAIL,50000000,79957634,187858642,267816276
2009,Law Abiding Citizen,FAIL,53000000,73357727,131159781,204517508
2009,Life During Wartime,PASS,4500000,281447,281447,562894
2009,Micmacs (Micmacs &agrave; tire-larigot),FAIL,42000000,1259693,11756922,13016615
2009,Monsters vs Aliens,FAIL,175000000,198351526,381687380,580038906
2009,Moon,FAIL,5000000,5010163,10676073,15686236
2009,Mother and Child,PASS,7000000,1110509,5010509,6121018
2009,My Bloody Valentine 3D,FAIL,14000000,51545952,102754998,154300950
2009,My Sister&#39;s Keeper,PASS,27500000,49200230,96673002,145873232
2009,Nine,FAIL,80000000,19676965,53508858,73185823
2009,Ninja Assassin,FAIL,50000000,38122883,61622883,99745766
2009,Nowhere Boy,FAIL,1900000,1445366,7785229,9230595
2009,Ondine,PASS,12000000,550472,550472,1100944
2009,Paa,FAIL,4300000,199228,9791282,9990510
2009,Pandorum,FAIL,40000000,10330853,17033431,27364284
2009,Perrier&#39;s Bounty,FAIL,6600000,828,828,1656
2009,Planet 51,FAIL,60000000,42194060,108996113,151190173
2009,Precious: Based on the Novel Push by Sapphire,PASS,10000000,47566524,68722848,116289372
2009,Public Enemies,FAIL,102500000,97104620,210379983,307484603
2009,Push,PASS,38000000,31811527,44411527,76223054
2009,Sherlock Holmes,FAIL,90000000,209028679,498438212,707466891
2009,Splice,PASS,30000000,17010170,22461001,39471171
2009,Star Trek,PASS,140000000,257730019,385680446,643410465
2009,State of Play,PASS,60000000,37017955,91445389,128463344
2009,Surrogates,FAIL,80000000,38577772,119668350,158246122
2009,Terminator Salvation,FAIL,200000000,125322469,371628539,496951008
2009,The Blind Side,FAIL,35000000,255959475,305705795,561665270
2009,The Boat That Rocked,FAIL,50000000,8017467,37472651,45490118
2009,The Boondock Saints II: All Saints Day,FAIL,8000000,10273187,10273187,20546374
2009,The Box,PASS,25000000,15051977,26341896,41393873
2009,The City of Your Final Destination,PASS,8300000,493296,1353296,1846592
2009,The Final Destination,PASS,40000000,66477700,187384627,253862327
2009,The Fourth Kind,PASS,10000000,26218170,49486874,75705044
2009,The Girl with the Dragon Tattoo,FAIL,90000000,102515793,233170238,335686031
2009,The Girlfriend Experience,FAIL,1300000,695840,1005840,1701680
2009,The Good Guy,PASS,10000000,100688,100688,201376
2009,The Hangover,FAIL,35000000,277322503,469553471,746875974
2009,The Imaginarium of Doctor Parnassus,FAIL,30000000,7689607,64352607,72042214
2009,The Informant!,FAIL,22000000,33316821,41771168,75087989
2009,The Invention of Lying,FAIL,18500000,18451251,32679264,51130515
2009,The Last Station,PASS,18000000,6617867,15696146,22314013
2009,The Lovely Bones,PASS,95000000,44114232,94894448,139008680
2009,The Men Who Stare at Goats,FAIL,24000000,32428195,67348218,99776413
2009,The Messenger,FAIL,6500000,1109660,1409660,2519320
2009,The Princess and the Frog,PASS,105000000,104400899,270997378,375398277
2009,The Proposal,FAIL,40000000,163958031,314709717,478667748
2009,The Road,FAIL,25000000,8114270,27614270,35728540
2009,The Secret of Kells,FAIL,8000000,690290,2600916,3291206
2009,The Soloist,FAIL,60000000,31720158,38454152,70174310
2009,The Taking of Pelham 123,FAIL,110000000,65452312,152364370,217816682
2009,The Time Traveler&#39;s Wife,FAIL,39000000,63414846,98666635,162081481
2009,The Ugly Truth,FAIL,38000000,88915214,205230042,294145256
2009,The Unborn,PASS,16000000,42670410,78208812,120879222
2009,The Young Victoria,PASS,35000000,11001272,31878891,42880163
2009,Transformers: Revenge of the Fallen,PASS,210000000,402111870,836519699,1238631569
2009,Up,FAIL,175000000,293004164,731542621,1024546785
2009,Up in the Air,FAIL,30000000,83823381,166842739,250666120
2009,Veronika Decides to Die,PASS,9000000,N/A,N/A,#VALUE!
2009,Watchmen,FAIL,138000000,107509799,184068357,291578156
2009,Whatever Works,FAIL,15000000,5306706,35106706,40413412
2009,Where the Wild Things Are,FAIL,100000000,77233467,99123656,176357123
2009,Whip It,PASS,15000000,13043363,18856151,31899514
2009,Whiteout,PASS,35000000,10275638,12254746,22530384
2009,X-Men Origins: Wolverine,FAIL,150000000,179883157,374825760,554708917
2009,Yesterday Was a Lie,PASS,200000,N/A,N/A,#VALUE!
2009,Youth in Revolt,FAIL,18000000,15285588,19685588,34971176
2009,Zombieland,PASS,23600000,75590286,102236596,177826882
2008,21,PASS,35000000,81159365,157852532,239011897
2008,Appaloosa,FAIL,20000000,20211394,27735474,47946868
2008,Australia,FAIL,130000000,49554002,215080810,264634812
2008,Baby Mama,PASS,30000000,60494212,64391484,124885696
2008,Be Kind Rewind,FAIL,20000000,11175164,30894247,42069411
2008,Bedtime Stories,PASS,80000000,110101975,218357961,328459936
2008,Blindness,PASS,25000000,3073392,20052958,23126350
2008,Bolt,PASS,150000000,114053759,313953759,428007518
2008,Burn After Reading,FAIL,37000000,60355347,163415735,223771082
2008,Changeling,PASS,55000000,35739802,113805580,149545382
2008,Che: Part One,FAIL,58000000,293708,30118557,30412265
2008,City of Ember,PASS,38000000,7871693,11817059,19688752
2008,Cloverfield,PASS,25000000,80048433,170764033,250812466
2008,Day of the Dead,PASS,18000000,N/A,N/A,#VALUE!
2008,Death Race,FAIL,65000000,36316032,72516819,108832851
2008,Defiance,PASS,50000000,28644813,42268745,70913558
2008,"Definitely, Maybe",PASS,7000000,32241649,55863786,88105435
2008,Doomsday,PASS,33000000,11008770,21621188,32629958
2008,Doubt,PASS,20000000,33446470,50946957,84393427
2008,Eagle Eye,FAIL,80000000,101440743,178066569,279507312
2008,Easy Virtue,PASS,14000000,2656784,12656784,15313568
2008,Fireproof,FAIL,500000,33456317,33473297,66929614
2008,Fly Me to the Moon,FAIL,25000000,14543943,57546746,72090689
2008,Forgetting Sarah Marshall,PASS,30000000,63172463,105173042,168345505
2008,Four Christmases,PASS,80000000,120146040,163546040,283692080
2008,Frost/Nixon,FAIL,29000000,18622031,28144586,46766617
2008,Frozen River,PASS,1000000,2511476,6030129,8541605
2008,Gake no ue no Ponyo,PASS,34000000,15090399,205312666,220403065
2008,Ghost Town,FAIL,20000000,13252641,26612350,39864991
2008,Gran Torino,FAIL,25000000,148095302,274543085,422638387
2008,Hamlet 2,PASS,9000000,4886216,4898285,9784501
2008,Hancock,FAIL,150000000,227946274,624346274,852292548
2008,Herb &amp; Dorothy,PASS,82500000,75986503,160388063,236374566
2008,High School Musical 3: Senior Year,PASS,11000000,90559416,274392880,364952296
2008,Igor,FAIL,30000000,19528602,31013349,50541951
2008,In Bruges,FAIL,15000000,7800825,34533783,42334608
2008,Indiana Jones and the Kingdom of the Crystal Skull,FAIL,185000000,317023851,786558145,1103581996
2008,Inkheart,PASS,60000000,17303424,58051454,75354878
2008,Iron Man,FAIL,186000000,318604126,582443126,901047252
2008,Journey to the Center of the Earth,FAIL,45000000,101704370,240904370,342608740
2008,Jumper,FAIL,82500000,81168265,223113205,304281470
2008,Kung Fu Panda,FAIL,130000000,215434591,631910531,847345122
2008,L&aring;t den r&auml;tte komma in (Let the Right One In),FAIL,4500000,2122085,12247682,14369767
2008,Made of Honor,FAIL,40000000,46012734,106548738,152561472
2008,Max Payne,PASS,35000000,40687294,85761789,126449083
2008,Meet Dave,FAIL,60000000,11803254,50648806,62452060
2008,Milk,FAIL,20000000,31841299,57293371,89134670
2008,Miracle at St. Anna,FAIL,45000000,7916887,9110458,17027345
2008,Nick and Norah&#39;s Infinite Playlist,PASS,10000000,31487293,33544594,65031887
2008,Nim&#39;s Island,PASS,37000000,48006762,94081683,142088445
2008,Pineapple Express,FAIL,26000000,87341380,101549277,188890657
2008,Pontypool,FAIL,1500000,3865,31916,35781
2008,Possession,PASS,25000000,10103647,14805812,24909459
2008,Prom Night,PASS,18000000,43869350,57109687,100979037
2008,Quantum of Solace,FAIL,230000000,169368427,591692078,761060505
2008,Quarantine,PASS,12000000,31691811,41291811,72983622
2008,Rachel Getting Married,PASS,12000000,12796861,13326864,26123725
2008,Revolutionary Road,PASS,45000000,22911480,79564960,102476440
2008,RocknRolla,FAIL,18000000,5700626,27794339,33494965
2008,Seven Pounds,PASS,54000000,69951824,166617328,236569152
2008,Sex and the City,PASS,57500000,152647258,415247258,567894516
2008,Slumdog Millionaire,FAIL,14000000,141319928,384519665,525839593
2008,Speed Racer,PASS,120000000,43945766,93394462,137340228
2008,Stargate: The Ark of Truth,FAIL,7000000,N/A,N/A,#VALUE!
2008,Step Brothers,FAIL,65000000,100468793,128468793,228937586
2008,Sunshine Cleaning,PASS,5000000,12062558,16462558,28525116
2008,"Synecdoche, New York",FAIL,20000000,3083538,4383538,7467076
2008,Taken,PASS,25000000,145000989,226941585,371942574
2008,The Bank Job,PASS,20000000,30060660,66143005,96203665
2008,The Brothers Bloom,FAIL,20000000,3531756,5531756,9063512
2008,The Chronicles of Narnia: Prince Caspian,PASS,225000000,141621490,419490286,561111776
2008,The Curious Case of Benjamin Button,FAIL,160000000,127509326,329809326,457318652
2008,The Dark Knight,FAIL,185000000,533345358,1002891358,1536236716
2008,The Day the Earth Stood Still,PASS,80000000,79366978,233066978,312433956
2008,The Eye,PASS,12000000,31418697,56918697,88337394
2008,The Forbidden Kingdom,FAIL,55000000,52075270,129075270,181150540
2008,The House Bunny,PASS,25000000,48237389,70237389,118474778
2008,The Hurt Locker,FAIL,15000000,17017811,49894223,66912034
2008,The Incredible Hulk,FAIL,137500000,134806913,263417913,398224826
2008,The Lucky Ones,PASS,14000000,266967,266967,533934
2008,The Other Boleyn Girl,PASS,40000000,26814957,77714957,104529914
2008,The Reader,FAIL,32500000,34194407,113019290,147213697
2008,The Secret Life of Bees,PASS,11000000,37770162,39984023,77754185
2008,The Sisterhood of the Traveling Pants 2,PASS,27000000,44089964,44270131,88360095
2008,The Strangers,FAIL,9000000,52597610,83051676,135649286
2008,The Tale of Despereaux,PASS,60000000,50877145,90482317,141359462
2008,The Women,PASS,16000000,26902075,50103808,77005883
2008,The Wrestler,FAIL,6000000,26238243,46634275,72872518
2008,Three Kingdoms: Resurrection of the Dragon,FAIL,20000000,N/A,22139590,#VALUE!
2008,Transsiberian,PASS,15000000,2203641,6379575,8583216
2008,Tropic Thunder,FAIL,90000000,110461307,188163455,298624762
2008,Twilight,PASS,37000000,192769854,397923934,590693788
2008,Valkyrie,FAIL,90000000,83077762,203902107,286979869
2008,Vicky Cristina Barcelona,PASS,16000000,23216709,104504817,127721526
2008,WALL-E,FAIL,180000000,223808164,532590994,756399158
2008,Waltz with Bashir,FAIL,2000000,2283849,11125664,13409513
2008,Wanted,FAIL,75000000,134508551,342416460,476925011
2008,"Welcome Home, Roscoe Jenkins",FAIL,27500000,42436517,43607627,86044144
2008,Wendy and Lucy,PASS,300000,865695,1416046,2281741
2008,What Happens In Vegas,PASS,35000000,80277646,218535708,298813354
2008,Yes Man,FAIL,50000000,97690976,225990976,323681952
2007,[Rec],PASS,2100000,N/A,27117954,#VALUE!
2007,1408,PASS,22500000,71985628,131263370,203248998
2007,28 Weeks Later,PASS,15000000,28638916,64232714,92871630
2007,3:10 to Yuma,FAIL,48000000,53606916,71171825,124778741
2007,30 Days of Night,FAIL,30000000,39568996,80276156,119845152
2007,88 Minutes,FAIL,30000000,16930884,32955399,49886283
2007,Across the Universe,PASS,45000000,24343673,29367143,53710816
2007,Atonement,PASS,30000000,50980159,130200290,181180449
2007,Becoming Jane,PASS,16500000,18663911,39364948,58028859
2007,Beowulf,PASS,150000000,82195215,194995215,277190430
2007,Blades of Glory,PASS,61000000,118594548,145594548,264189096
2007,Bridge to Terabithia,PASS,25000000,82234139,137984788,220218927
2007,Brooklyn Rules,PASS,8000000,458232,458232,916464
2007,Charlie Bartlett,FAIL,12000000,3950294,5295909,9246203
2007,Charlie Wilson&#39;s War,PASS,75000000,66661095,119512771,186173866
2007,Death at a Funeral,PASS,21000000,42739347,48977233,91716580
2007,Diary of the Dead,PASS,2750000,952620,5394447,6347067
2007,Disturbia,PASS,20000000,80209692,117573043,197782735
2007,Eastern Promises,PASS,50000000,17181265,55367342,72548607
2007,Enchanted,PASS,85000000,127706877,340384141,468091018
2007,Fantastic Four: Rise of the Silver Surfer,FAIL,120000000,131921738,288215319,420137057
2007,Gone Baby Gone,PASS,19000000,20300218,34619699,54919917
2007,Hairspray,PASS,75000000,118871849,202871849,321743698
2007,Halloween,PASS,15000000,58269151,77514401,135783552
2007,Hannibal Rising,FAIL,50000000,27669725,80583311,108253036
2007,Harry Potter and the Order of the Phoenix,PASS,150000000,292004738,942943935,1234948673
2007,Hitman,FAIL,17500000,39687694,99965792,139653486
2007,Hostel: Part II,PASS,7500000,17544812,33606409,51151221
2007,Hot Fuzz,FAIL,16000000,23618786,81742618,105361404
2007,Hot Rod,FAIL,25000000,13938332,14334401,28272733
2007,I Am Legend,PASS,150000000,256393010,585410052,841803062
2007,Into the Wild,FAIL,20000000,18354356,56395211,74749567
2007,Juno,PASS,7000000,143495265,231450102,374945367
2007,Knocked Up,PASS,27500000,148761765,219154490,367916255
2007,Lars and the real Girl,PASS,12500000,5956480,10553442,16509922
2007,Live Free or Die Hard,FAIL,110000000,134529403,383531464,518060867
2007,Michael Clayton,FAIL,21500000,49033882,92987651,142021533
2007,Music and Lyrics,FAIL,40000000,50572589,145021477,195594066
2007,No Country for Old Men,FAIL,25000000,74273505,164051250,238324755
2007,No Reservations,PASS,28000000,43107979,91665799,134773778
2007,Paranormal Activity,FAIL,450000,107918810,194183034,302101844
2007,Persepolis,PASS,7300000,4443403,22742498,27185901
2007,Pirates of the Caribbean: At World&#39;s End,PASS,300000000,309420425,960996492,1270416917
2007,Premonition,PASS,20000000,47852604,81461343,129313947
2007,Ratatouille,FAIL,150000000,206445654,626549695,832995349
2007,Resident Evil: Extinction,PASS,45000000,50648679,146162920,196811599
2007,Rush Hour 3,FAIL,180000000,140125968,253025968,393151936
2007,Shooter,FAIL,60000000,47003582,95703582,142707164
2007,Shrek the Third,PASS,160000000,322719944,807330936,1130050880
2007,St. Trinian&#39;s,PASS,11400000,15000,22446568,22461568
2007,Stardust,PASS,70000000,38634938,135556675,174191613
2007,Sunshine,FAIL,40000000,3688560,32030610,35719170
2007,Superbad,FAIL,17500000,121463226,169863226,291326452
2007,Sydney White,PASS,16500000,11892415,13636339,25528754
2007,Teeth,FAIL,2000000,347578,2350641,2698219
2007,The Bucket List,FAIL,45000000,93466502,174310293,267776795
2007,The Golden Compass,PASS,205000000,70107728,372234864,442342592
2007,The Kite Runner,FAIL,20000000,15800078,74180745,89980823
2007,The Man from Earth,FAIL,200000,N/A,N/A,#VALUE!
2007,The Messengers,PASS,16000000,35374833,53774833,89149666
2007,The Mist,PASS,13000000,25593755,54777490,80371245
2007,The Number 23,FAIL,32000000,35193167,77593167,112786334
2007,The Savages,PASS,9000000,6623082,10642023,17265105
2007,The Signal,FAIL,50000,251150,406299,657449
2007,The Simpsons Movie,PASS,72500000,183135014,527071022,710206036
2007,The Visitor,FAIL,4000000,9427026,19174817,28601843
2007,There Will Be Blood,FAIL,25000000,40222514,77208711,117431225
2007,TMNT,FAIL,35000000,54149098,96096018,150245116
2007,Transformers,FAIL,151000000,319246193,708272592,1027518785
2007,Tropa de Elite,PASS,6537890,8744,14319195,14327939
2007,Waitress,PASS,1500000,19097550,22217183,41314733
2007,We Own the Night,FAIL,28000000,28563179,55307857,83871036
2007,White Noise 2: The Light,FAIL,10000000,N/A,8243567,#VALUE!
2006,300,FAIL,60000000,210614939,454161935,664776874
2006,A Scanner Darkly,FAIL,20000000,5501616,7405084,12906700
2006,Akeelah and the Bee,PASS,8000000,18848430,18959424,37807854
2006,Aquamarine,PASS,12000000,18597342,22978953,41576295
2006,Bandidas,PASS,35000000,N/A,18400000,#VALUE!
2006,Black Christmas,PASS,9000000,16235738,16235738,32471476
2006,Blood Diamond,FAIL,100000000,57377916,171377916,228755832
2006,"Bon Cop, Bad Cop",FAIL,8000000,12671300,12671300,25342600
2006,Borat: Cultural Learnings of America for Make Benefit Glorious Nation of Kazakhstan,FAIL,18000000,128505958,261572744,390078702
2006,Bug,PASS,4000000,7006708,7006708,14013416
2006,Cars,FAIL,70000000,244082982,461667967,705750949
2006,Casino Royale,FAIL,102000000,167365000,596365000,763730000
2006,Children of Men,PASS,76000000,35552383,69450202,105002585
2006,Clerks II,FAIL,5000000,24148068,25894473,50042541
2006,Crank,FAIL,12000000,27838408,43924923,71763331
2006,Das Leben Der Anderen,FAIL,2000000,11284657,81197047,92481704
2006,DOA: Dead or Alive,PASS,30000000,480314,7756224,8236538
2006,El laberinto del fauno (Pan's Labyrinth),PASS,16000000,37634615,87041569,124676184
2006,Eragon,FAIL,100000000,75030163,249488115,324518278
2006,Fido,FAIL,8000000,298110,419801,717911
2006,Final Destination 3,PASS,25000000,54098051,112798051,166896102
2006,Flushed Away,FAIL,149000000,64665672,177665672,242331344
2006,For Your Consideration,PASS,12000000,5549923,5549923,11099846
2006,Friends with Money,PASS,6500000,13368437,17518322,30886759
2006,Ice Age: The Meltdown,FAIL,75000000,195330621,651899282,847229903
2006,Idlewild,PASS,15000000,12669914,12669914,25339828
2006,Inside Man,FAIL,50000000,88634237,184634237,273268474
2006,Jackass Number Two,FAIL,11000000,72778712,85278712,158057424
2006,Lady in the Water,FAIL,75000000,42285169,72785169,115070338
2006,Last Holiday,PASS,45000000,38399961,43343247,81743208
2006,Letters from Iwo Jima,FAIL,13000000,13756082,68756082,82512164
2006,Little Children,PASS,14000000,5463019,14763019,20226038
2006,Little Miss Sunshine,PASS,8000000,59891098,100550977,160442075
2006,London To Brighton,PASS,825000,N/A,610776,#VALUE!
2006,Lucky Number Slevin,FAIL,27000000,22495466,55495466,77990932
2006,Man of the Year,FAIL,20000000,37442180,41342180,78784360
2006,Marie Antoinette,PASS,40000000,15962471,60862471,76824942
2006,Miss Potter,PASS,30000000,3005605,35891257,38896862
2006,Monster House,PASS,75000000,73661010,141267370,214928380
2006,Nacho Libre,FAIL,32000000,80197993,99296462,179494455
2006,Night at the Museum,PASS,110000000,250863268,574480841,825344109
2006,Notes on a Scandal,PASS,27500000,17510118,49752391,67262509
2006,Once,FAIL,150000,9445857,18997174,28443031
2006,Open Season,FAIL,85000000,85105259,189901703,275006962
2006,Paris je t&#39;aime,FAIL,13000000,4857374,4857374,9714748
2006,Perfume: The Story of a Murderer,PASS,63700000,2223293,133603463,135826756
2006,Pirates of the Caribbean: Dead Man&#39;s Chest,FAIL,225000000,423315812,1060615812,1483931624
2006,Poseidon,FAIL,160000000,60674817,181674817,242349634
2006,Quinceanera,PASS,400000,1692693,2522787,4215480
2006,Rang De Basanti,PASS,5300000,2197694,29197694,31395388
2006,Running with Scissors,PASS,12000000,6860000,8706701,15566701
2006,She&#39;s the Man,FAIL,25000000,33889159,55279608,89168767
2006,Sherrybaby,FAIL,2000000,199176,622806,821982
2006,Shortbus,PASS,2000000,1985292,1985292,3970584
2006,Silent Hill,PASS,50000000,46982632,99982632,146965264
2006,Slither,PASS,15250000,7802450,12930343,20732793
2006,Smokin&#39; Aces,FAIL,17000000,35662731,56047261,91709992
2006,Snakes on a Plane,PASS,33000000,34020814,62020814,96041628
2006,Southland Tales,PASS,17000000,275380,364607,639987
2006,Stick It,PASS,20000000,26910736,30399714,57310450
2006,Stranger Than Fiction,PASS,30000000,40435190,45235190,85670380
2006,Superman Returns,FAIL,232000000,200120000,390874000,590994000
2006,Take the Lead,PASS,30000000,34742066,65390493,100132559
2006,The Ant Bully,FAIL,45000000,28142535,49610898,77753433
2006,The Break Up,FAIL,52000000,118806699,202944203,321750902
2006,The Da Vinci Code,FAIL,125000000,217536138,767820459,985356597
2006,The Dead Girl,PASS,3300000,19875,19875,39750
2006,The Departed,FAIL,90000000,133311000,290539042,423850042
2006,The Devil Wears Prada,PASS,35000000,124740460,326551094,451291554
2006,The Fountain,FAIL,35000000,10144010,15461638,25605648
2006,The Grudge 2,PASS,20000000,39143839,70743839,109887678
2006,The History Boys,FAIL,3700000,2730296,13425589,16155885
2006,The Holiday,PASS,85000000,63280000,205190324,268470324
2006,The Host,PASS,50000000,26623701,58188384,84812085
2006,The Illusionist,FAIL,16500000,39868642,83792062,123660704
2006,The Lake House,FAIL,40000000,52330111,114830111,167160222
2006,The Painted Veil,FAIL,19400000,8060487,15118795,23179282
2006,The Prestige,FAIL,40000000,53089891,107896006,160985897
2006,The Pursuit of Happyness,FAIL,55000000,162586036,307325633,469911669
2006,The Queen,FAIL,15000000,56441711,128885873,185327584
2006,The Wind That Shakes the Barley,FAIL,8300000,1829142,25670174,27499316
2006,Ultraviolet,FAIL,30000000,18522064,20722064,39244128
2006,Volver,PASS,9400000,12899867,85599867,98499734
2006,We Are Marshall,FAIL,65000000,43545364,43545364,87090728
2006,When a Stranger Calls,PASS,15000000,47860214,66944472,114804686
2006,Wristcutters: A Love Story,FAIL,1000000,446165,460136,906301
2006,X-Men: The Last Stand,PASS,210000000,234362462,459359555,693722017
2006,"You, Me and Dupree",FAIL,54000000,75802010,130402010,206204020
2006,Zoom,PASS,35000000,11989328,12506188,24495516
2006,Zwartboek,PASS,22000000,4398532,27238354,31636886
2005,AEon Flux,PASS,55000000,25857987,47953341,73811328
2005,Assault on Precinct 13,PASS,30000000,20040895,36040895,56081790
2005,Batman Begins,FAIL,150000000,205343774,373298774,578642548
2005,Beauty Shop,PASS,25000000,36351350,38351350,74702700
2005,Bewitched,PASS,80000000,63313159,131159306,194472465
2005,BloodRayne,FAIL,25000000,2405420,3605420,6010840
2005,Boogeyman,FAIL,20000000,46752382,67192859,113945241
2005,Boynton Beach Club,PASS,2900000,3127472,3127472,6254944
2005,Brick,FAIL,450000,2075743,4087493,6163236
2005,Brokeback Mountain,FAIL,13900000,83043761,174097801,257141562
2005,Capote,FAIL,7000000,28750530,49924079,78674609
2005,Charlie and the Chocolate Factory,PASS,150000000,206459076,474459076,680918152
2005,Chinjeolhan geumjassi,PASS,4500000,211667,23471871,23683538
2005,Cinderella Man,FAIL,88000000,61649911,108539911,170189822
2005,Coach Carter,PASS,45000000,67264877,76669806,143934683
2005,Constantine,FAIL,75000000,75976178,230884728,306860906
2005,Conversations with Other Women,FAIL,450000,379418,909061,1288479
2005,Corpse Bride,FAIL,30000000,53359111,114770654,168129765
2005,Cursed,PASS,35000000,19294901,25114901,44409802
2005,Danny the dog,FAIL,43000000,24537621,49037621,73575242
2005,Dark Water,PASS,60000000,25473093,49473093,74946186
2005,Dear Wendy,FAIL,8000000,23106,446438,469544
2005,Domino,PASS,50000000,10169202,22969202,33138404
2005,Doom,FAIL,70000000,28212337,54612337,82824674
2005,Fantastic Four,FAIL,87500000,154696080,330717080,485413160
2005,Flightplan,PASS,55000000,89706988,225706988,315413976
2005,Fun with Dick and Jane,PASS,140000000,110550000,201798116,312348116
2005,"Good Night, and Good Luck.",FAIL,7000000,31501218,56586901,88088119
2005,Hard Candy,PASS,950000,1024640,8267066,9291706
2005,Harry Potter and the Goblet of Fire,FAIL,150000000,290013036,896911078,1186924114
2005,Herbie Fully Loaded,PASS,50000000,66010682,144110682,210121364
2005,Hide and Seek,PASS,25000000,51100486,123100486,174200972
2005,Hitch,FAIL,55000000,177784257,366784257,544568514
2005,Hoodwinked!,PASS,17500000,51386611,109843390,161230001
2005,Hostel,FAIL,4800000,47326473,82241110,129567583
2005,Hustle &amp; Flow,FAIL,2800000,22202809,23563727,45766536
2005,Ice Princess,PASS,25000000,24381334,25732334,50113668
2005,Jarhead,FAIL,72000000,62647540,96947540,159595080
2005,Junebug,PASS,1000000,2678010,3557954,6235964
2005,Just Like Heaven,PASS,58000000,48318130,100687083,149005213
2005,King Kong,FAIL,207000000,218080025,550517357,768597382
2005,Kingdom of Heaven,FAIL,110000000,47398413,218853353,266251766
2005,Kiss Kiss Bang Bang,FAIL,15000000,4235837,13105837,17341674
2005,Lord of War,FAIL,42000000,24149632,62142629,86292261
2005,Madagascar,FAIL,75000000,193595521,556559566,750155087
2005,Man of the House,PASS,50000000,19699706,22099706,41799412
2005,Match Point,PASS,15000000,23089926,87989926,111079852
2005,Me and You and Everyone We Know,PASS,2000000,3885134,8425527,12310661
2005,Memoirs of a Geisha,PASS,85000000,57010853,161510853,218521706
2005,MirrorMask,PASS,4000000,864959,963224,1828183
2005,Miss Congeniality 2: Armed &amp; Fabulous,PASS,60000000,48478006,101382396,149860402
2005,Mr. &amp; Mrs. Smith,FAIL,110000000,186336279,478336279,664672558
2005,Munich,FAIL,75000000,47379090,130279090,177658180
2005,North Country,PASS,30000000,18324242,25224242,43548484
2005,Oliver Twist,FAIL,65000000,2070920,26670920,28741840
2005,Pride and Prejudice,PASS,28000000,38372662,120918508,159291170
2005,Proof,PASS,20000000,7535331,8284331,15819662
2005,Red Eye,PASS,26000000,57891803,95555805,153447608
2005,Rent,PASS,40000000,29077547,31670620,60748167
2005,Robots,FAIL,80000000,128200012,260700012,388900024
2005,Saw II,FAIL,5000000,87025093,152925093,239950186
2005,Serenity,PASS,39000000,25514517,38514517,64029034
2005,Shopgirl,FAIL,7500000,10284523,11758418,22042941
2005,Sin City,PASS,40000000,74103820,158753820,232857640
2005,Sisters in Law,PASS,300000,33312,33312,66624
2005,Sky High,PASS,60000000,63939454,81627454,145566908
2005,Son of the Mask,FAIL,100000000,17018422,59918422,76936844
2005,Star Wars: Episode III - Revenge of the Sith,FAIL,115000000,380270577,848998877,1229269454
2005,Stealth,FAIL,138000000,32116746,76416746,108533492
2005,Strangers with Candy,PASS,2000000,2072645,2077844,4150489
2005,Thank You for Smoking,FAIL,7500000,24793509,40016662,64810171
2005,The 40 Year Old Virgin,FAIL,26000000,109449237,177360047,286809284
2005,The Adventures of Sharkboy and Lavagirl 3-D,FAIL,50000000,39177684,69425966,108603650
2005,The Amityville Horror,PASS,18500000,65233369,109175673,174409042
2005,The Ballad of Jack and Rose,PASS,1500000,712294,1126258,1838552
2005,"The Chronicles of Narnia: The Lion, the Witch and the Wardrobe",PASS,180000000,291710957,748806957,1040517914
2005,The Constant Gardener,PASS,25500000,33579798,81079798,114659596
2005,The Descent,PASS,7000000,26024456,57029609,83054065
2005,The Devil&#39;s Rejects,PASS,7000000,17044981,20940428,37985409
2005,The Exorcism of Emily Rose,PASS,18000000,75072454,144587700,219660154
2005,The Fog,PASS,18000000,29511112,37048526,66559638
2005,The Hitchhiker&#39;s Guide to the Galaxy,FAIL,45000000,51019112,104019112,155038224
2005,The Island,PASS,120000000,35818913,163018913,198837826
2005,The Jacket,FAIL,28500000,6301131,15452978,21754109
2005,The Legend of Zorro,FAIL,80000000,45575336,141475336,187050672
2005,The New World,FAIL,30000000,12712093,26184400,38896493
2005,The Ring Two,PASS,50000000,75941727,161941727,237883454
2005,The Skeleton Key,PASS,40000000,47907715,92256918,140164633
2005,The Squid and the Whale,FAIL,1500000,7372734,11191423,18564157
2005,The Wedding Date,PASS,15000000,31726995,47175038,78902033
2005,Transamerica,PASS,1000000,9015303,16553163,25568466
2005,Tristram Shandy: A Cock and Bull Story,FAIL,4750000,1253413,3061763,4315176
2005,V for Vendetta,PASS,50000000,70511035,129231542,199742577
2005,Waiting...,PASS,1125000,16124543,18673274,34797817
2005,Walk the Line,PASS,29000000,119519402,187707495,307226897
2005,War of the Worlds,FAIL,132000000,234280354,606836535,841116889
2005,Water,PASS,3000000,5529144,8119205,13648349
2005,White Noise,FAIL,10000000,56094360,92094360,148188720
2005,"Yours, Mine and Ours",PASS,45000000,53359917,72359917,125719834
2005,Zathura: A Space Adventure,FAIL,65000000,28045540,58545540,86591080
2004,13 Going on 30,PASS,30000000,57139723,96439723,153579446
2004,2046,PASS,12000000,1442338,19202856,20645194
2004,50 First Dates,FAIL,75000000,120776832,196324496,317101328
2004,A Cinderella Story,PASS,19000000,51438175,70067909,121506084
2004,A Home at the End of The World,FAIL,6500000,1029017,1033810,2062827
2004,A Very Long Engagement,PASS,55000000,6167817,59606587,65774404
2004,Anchorman: The Legend of Ron Burgundy,FAIL,25000000,84136909,89366354,173503263
2004,Around the World in 80 Days,FAIL,110000000,24004159,72004159,96008318
2004,AVP: Alien vs. Predator,FAIL,70000000,80281096,172543519,252824615
2004,Banlieue 13,FAIL,15000000,1200216,11208291,12408507
2004,Before Sunset,FAIL,2000000,5792822,11293790,17086612
2004,Bridget Jones: The Edge of Reason,PASS,50000000,40203020,263894551,304097571
2004,Catwoman,PASS,100000000,40202379,82145379,122347758
2004,Cellular,PASS,45000000,32003620,61475984,93479604
2004,Closer,PASS,35000000,33987757,115476509,149464266
2004,Collateral,FAIL,60000000,100170152,217670152,317840304
2004,Connie and Carla,PASS,20000000,8047525,8047525,16095050
2004,Crash,PASS,7303082,55334418,101173038,156507456
2004,D.E.B.S.,PASS,3500000,96793,96793,193586
2004,Dawn of the Dead,PASS,28000000,58990765,103452875,162443640
2004,Dodgeball: A True Underdog Story,PASS,30000000,114326736,167791704,282118440
2004,Ella Enchanted,PASS,35000000,22913677,22913677,45827354
2004,Eternal Sunshine of the Spotless Mind,FAIL,20000000,34366518,72993444,107359962
2004,Eulogy,PASS,10000000,70527,70527,141054
2004,Finding Neverland,PASS,25000000,51676606,115036108,166712714
2004,Flight of the Phoenix,FAIL,75000000,21009180,34009180,55018360
2004,Garden State,PASS,2500000,26782316,36028802,62811118
2004,Harold and Kumar Go to White Castle,PASS,9000000,18225165,18225165,36450330
2004,Harry Potter and the Prisoner of  Azkaban,PASS,130000000,249538952,796688549,1046227501
2004,Hellboy,FAIL,60000000,59623958,99823958,159447916
2004,Home on the Range,PASS,110000000,50026353,76482461,126508814
2004,I Heart Huckabees,PASS,22000000,12784713,20034713,32819426
2004,"I, Robot",FAIL,105000000,144801023,348601023,493402046
2004,In Good Company,FAIL,26000000,45489752,63489752,108979504
2004,Kinsey,PASS,11000000,10214647,13000959,23215606
2004,Kung Fu Hustle,FAIL,20000000,17104669,101004669,118109338
2004,Layer Cake,FAIL,6500000,2339957,11850214,14190171
2004,Lemony Snicket&#39;s A Series of Unfortunate Events,PASS,100000000,118627117,201627117,320254234
2004,Maria Full of Grace,PASS,3200000,6529624,14441158,20970782
2004,Mean Girls,PASS,18000000,86047227,130953026,217000253
2004,Million Dollar Baby,PASS,30000000,100492203,232016402,332508605
2004,Miracle,FAIL,28000000,64378093,64474705,128852798
2004,My Summer of Love,PASS,1700000,1000915,4951476,5952391
2004,Napoleon Dynamite,FAIL,400000,44540956,46122713,90663669
2004,New York Minute,FAIL,40000000,14018364,21215882,35234246
2004,Primer,FAIL,7000,424760,565846,990606
2004,Raising Helen,PASS,50000000,37485528,43340302,80825830
2004,Ray,FAIL,40000000,75305995,124823094,200129089
2004,Resident Evil: Apocalypse,PASS,50000000,50740078,128940078,179680156
2004,Saved!,PASS,5000000,8886160,10228228,19114388
2004,Saw,FAIL,1200000,55185045,103096345,158281390
2004,Secret Window,FAIL,40000000,47958031,92111551,140069582
2004,Shark Tale,FAIL,75000000,161412000,367825111,529237111
2004,Shaun of the Dead,PASS,5000000,13542874,30332385,43875259
2004,Shrek 2,PASS,70000000,441226247,937008132,1378234379
2004,Sideways,PASS,17000000,71502303,109874155,181376458
2004,Sky Captain and the World of Tomorrow,PASS,70000000,37760080,49730854,87490934
2004,Spanglish,PASS,75000000,42044321,54344321,96388642
2004,Spider-Man 2,FAIL,200000000,373524485,783705001,1157229486
2004,Team America: World Police,FAIL,20000000,32774834,50274834,83049668
2004,The Aviator,FAIL,110000000,102608827,214608827,317217654
2004,The Bourne Supremacy,FAIL,85000000,176087450,288587450,464674900
2004,The Butterfly Effect,FAIL,13000000,57924679,96046844,153971523
2004,The Chronicles of Riddick,FAIL,120000000,57712751,107212751,164925502
2004,The Day After Tomorrow,PASS,125000000,186740799,556319450,743060249
2004,The Grudge,PASS,10000000,110359362,187281115,297640477
2004,The Incredibles,PASS,92000000,261441092,632107545,893548637
2004,The Life Aquatic with Steve Zissou,FAIL,50000000,24006726,34806726,58813452
2004,The Notebook,FAIL,30000000,81001787,102276787,183278574
2004,The Phantom of the Opera,FAIL,55000000,51225796,158225796,209451592
2004,The Polar Express,FAIL,170000000,194949659,319049659,513999318
2004,The Princess Diaries 2: Royal Engagement,PASS,45000000,95149435,122071435,217220870
2004,The Stepford Wives,PASS,100000000,59475623,96221971,155697594
2004,The Terminal,FAIL,75000000,77073959,218673959,295747918
2004,The Village,PASS,71682975,114197520,257641634,371839154
2004,The Whole Ten Yards,FAIL,30000000,16323969,26323969,42647938
2004,Troy,FAIL,150000000,133298577,484161265,617459842
2004,Van Helsing,PASS,170000000,120150546,300150546,420301092
2004,Vera Drake,PASS,11000000,3753806,13353855,17107661
2004,White Chicks,PASS,20000000,69148997,111448997,180597994
2004,Wimbledon,PASS,35000000,16862585,41666476,58529061
2003,2 Fast 2 Furious,FAIL,76000000,127120058,236220058,363340116
2003,21 grams,FAIL,20000000,16248701,59667625,75916326
2003,Big Fish,FAIL,70000000,66432867,123432867,189865734
2003,Bon voyage,PASS,20000000,2353728,8361736,10715464
2003,Bruce Almighty,PASS,81000000,242704995,483473962,726178957
2003,Charlie&#39;s Angels: Full Throttle,PASS,120000000,100814328,227200000,328014328
2003,Cold Mountain,PASS,80000000,95632614,161632614,257265228
2003,Cradle 2 the Grave,FAIL,25000000,34657731,56434942,91092673
2003,Daddy Day Care,PASS,60000000,104148781,164285587,268434368
2003,Daredevil,FAIL,80000000,102543518,182782518,285326036
2003,Darkness Falls,FAIL,7000000,32539681,32539681,65079362
2003,Dreamcatcher,FAIL,68000000,33685268,75685268,109370536
2003,Final Destination 2,PASS,26000000,46896664,90396664,137293328
2003,Finding Nemo,FAIL,94000000,380529370,906465556,1286994926
2003,Freaky Friday,PASS,26000000,110222438,160822438,271044876
2003,Girl with a Pearl Earring,PASS,12000000,11634362,43281552,54915914
2003,Goodbye Lenin!,PASS,6400000,4063859,79384539,83448398
2003,Holes,FAIL,20000000,67383924,72383924,139767848
2003,Hollywood Homicide,FAIL,75000000,30207785,51107785,81315570
2003,House of Sand and Fog,PASS,16500000,13005485,16157923,29163408
2003,How to Lose a Guy in 10 Days,FAIL,50000000,105807520,177079973,282887493
2003,Hulk,FAIL,137000000,132177234,245229234,377406468
2003,Identity,FAIL,28000000,52131264,82183683,134314947
2003,In the Cut,PASS,12000000,4717455,23693646,28411101
2003,Jeepers Creepers II,PASS,25000000,35623801,35623801,71247602
2003,Kill Bill: Vol. 1,PASS,55000000,70098138,180098138,250196276
2003,Lara Croft Tomb Raider: The Cradle of Life,FAIL,90000000,65653758,156453758,222107516
2003,"Legally Blonde 2: Red, White &amp; Blonde",PASS,25000000,90639088,125339088,215978176
2003,Les triplettes de Belleville,PASS,2000000,7301288,14440113,21741401
2003,Lost In Translation,FAIL,4000000,44585453,112550685,157136138
2003,Love Actually,PASS,45000000,59472278,247967903,307440181
2003,Master and Commander: The Far Side of the World,FAIL,135000000,93926386,212912137,306838523
2003,Mona Lisa Smile,PASS,65000000,63803100,141205169,205008269
2003,Monster,PASS,5000000,34469210,58003694,92472904
2003,Mystic River,PASS,30000000,90135191,156835191,246970382
2003,Peter Pan,PASS,100000000,48417850,95255485,143673335
2003,Pirates of the Caribbean: The Curse of the Black Pearl,FAIL,125000000,305411224,634954103,940365327
2003,Pride and Prejudice,PASS,28000000,38372662,120918508,159291170
2003,S.W.A.T.,PASS,70000000,116877597,207154748,324032345
2003,Scary Movie 3,PASS,45000000,110000082,155200000,265200082
2003,Secondhand Lions,FAIL,30000000,42070939,47902566,89973505
2003,Shanghai Knights,FAIL,50000000,60470220,88316835,148787055
2003,Shattered Glass,FAIL,6000000,2207975,2932719,5140694
2003,Sinbad: Legend of the Seven Seas,FAIL,60000000,26483452,80767884,107251336
2003,Something&#39;s Gotta Give,FAIL,80000000,124685242,266685242,391370484
2003,Spy Kids 3-D: Game Over,PASS,40000000,111760631,167851995,279612626
2003,Swimming Pool,PASS,7800000,10130108,22441323,32571431
2003,Terminator 3: Rise of the Machines,PASS,170000000,150358296,433058296,583416592
2003,The Core,PASS,85000000,31111260,74132631,105243891
2003,The Italian Job,FAIL,60000000,106126012,176262839,282388851
2003,The Jungle Book 2,FAIL,20000000,47901582,135703599,183605181
2003,The Last Samurai,FAIL,140000000,111110575,456810575,567921150
2003,The League of Extraordinary Gentlemen,FAIL,78000000,66465204,179265204,245730408
2003,The Lord of the Rings: The Return of the King,FAIL,94000000,377845905,1141408667,1519254572
2003,The Matrix Reloaded,PASS,127000000,281553689,738576929,1020130618
2003,The Matrix Revolutions,PASS,110000000,139259759,424259759,563519518
2003,The Missing,PASS,65000000,26900336,38253433,65153769
2003,The School of Rock,FAIL,20000000,81261177,131161177,212422354
2003,Thirteen,PASS,2000000,4601043,9505996,14107039
2003,Timeline,FAIL,80000000,19480739,26703184,46183923
2003,Undead,PASS,750000,41196,229250,270446
2003,Underworld,FAIL,22000000,51970690,95708457,147679147
2003,Wrong Turn,PASS,10000000,15417771,28649556,44067327
2003,X2 (X-Men 2),PASS,125000000,214949694,407711549,622661243
2002,25th Hour,FAIL,4500000,13084595,25344490,38429085
2002,28 Days Later...,PASS,8000000,45064915,82955633,128020548
2002,8 femmes,PASS,8000000,3076425,42376425,45452850
2002,8 Mile,FAIL,41000000,116724075,242924075,359648150
2002,About Schmidt,FAIL,30000000,65005217,105823486,170828703
2002,Adaptation,FAIL,18500000,22498520,22498520,44997040
2002,All or Nothing,PASS,9000000,184255,184255,368510
2002,Antwone Fisher,FAIL,12500000,21078145,23367586,44445731
2002,Austin Powers in Goldmember,FAIL,63000000,213117789,292738626,505856415
2002,Bend It Like Beckham,PASS,5600000,32543449,76730377,109273826
2002,Blade II,FAIL,54000000,81676888,154338601,236015489
2002,Blue Crush,PASS,30000000,40118420,51618420,91736840
2002,Cabin Fever,PASS,1500000,21158188,30351664,51509852
2002,Carrie,PASS,30000000,35266619,85001659,120268278
2002,Catch Me If You Can,FAIL,52000000,164606800,351106800,515713600
2002,Chicago,PASS,30000000,170687518,307687518,478375036
2002,Crossroads,PASS,12000000,37188667,57000000,94188667
2002,Death to Smoochy,FAIL,50000000,8355815,8374062,16729877
2002,Die Another Day,FAIL,142000000,160942139,431942139,592884278
2002,Drumline,FAIL,20000000,56398162,56398162,112796324
2002,Equilibrium,FAIL,20000000,1190018,5345869,6535887
2002,Far from Heaven,PASS,13500000,15901849,29027914,44929763
2002,Frida,FAIL,12000000,25885000,55710675,81595675
2002,Funny Ha Ha,PASS,30000,77070,77070,154140
2002,Gangs of New York,FAIL,97000000,77730500,190400000,268130500
2002,Gerry,FAIL,7000000,254683,254683,509366
2002,Harry Potter and the Chamber of Secrets,PASS,100000000,261987880,878979634,1140967514
2002,High Crimes,PASS,42000000,41543207,63781100,105324307
2002,I Spy,FAIL,70000000,33561137,60279822,93840959
2002,Ice Age,FAIL,65000000,176387405,386116343,562503748
2002,Igby Goes Down,FAIL,9000000,4777465,4777465,9554930
2002,Insomnia,FAIL,46000000,67263182,113622499,180885681
2002,Lilo and Stitch,PASS,80000000,145771527,245800000,391571527
2002,Maid in Manhattan,PASS,55000000,93932896,163838217,257771113
2002,May,PASS,1750000,145540,497339,642879
2002,Men in Black II,FAIL,140000000,190418803,441767803,632186606
2002,Minority Report,FAIL,102000000,132024714,358824714,490849428
2002,Mr Deeds,FAIL,50000000,126293452,171269535,297562987
2002,My Big Fat Greek Wedding,PASS,5000000,241438208,352242522,593680730
2002,Panic Room,PASS,48000000,95308367,196308367,291616734
2002,Phone Booth,FAIL,11000000,46566212,97837138,144403350
2002,Queen of the Damned,PASS,35000000,30307804,30307804,60615608
2002,Rabbit-Proof Fence,PASS,7000000,6199600,16866928,23066528
2002,Real Women Have Curves,PASS,3000000,5853194,5853194,11706388
2002,Red Dragon,FAIL,78000000,92955420,206455420,299410840
2002,Reign of Fire,FAIL,60000000,43061982,82150183,125212165
2002,Resident Evil,PASS,35000000,40119709,103787401,143907110
2002,Scooby-Doo,PASS,84000000,153294164,276294164,429588328
2002,Signs,FAIL,70702619,227965690,408265690,636231380
2002,Snow Dogs,FAIL,32000000,81150692,116898028,198048720
2002,Solaris,FAIL,47000000,14970038,14970038,29940076
2002,Spider-Man,FAIL,139000000,403706375,821565375,1225271750
2002,Spirit: Stallion of the Cimarron,FAIL,80000000,73215310,106515310,179730620
2002,Spun,PASS,4500000,410241,1022649,1432890
2002,Spy Kids 2: Island of Lost Dreams,PASS,38000000,85846296,119721296,205567592
2002,Star Trek: Nemesis,FAIL,60000000,43254409,67312826,110567235
2002,Star Wars: Episode II - Attack of the Clones,FAIL,115000000,310676740,656695615,967372355
2002,The Adventures of Pluto Nash,FAIL,100000000,4411102,7094995,11506097
2002,The Banger Sisters,PASS,10000000,30306281,38067218,68373499
2002,The Bourne Identity,FAIL,60000000,121468960,213300000,334768960
2002,The Dangerous Lives of Altar Boys,FAIL,12000000,1779284,1779284,3558568
2002,The Good Girl,PASS,8000000,14018296,16856124,30874420
2002,The Hours,PASS,25000000,41675994,97030468,138706462
2002,The Importance of Being Earnest,PASS,15000000,8378141,8378141,16756282
2002,The Lord of the Rings: The Two Towers,FAIL,94000000,342548984,927048984,1269597968
2002,The Powerpuff Girls,PASS,25000000,11411644,16425701,27837345
2002,The Quiet American,FAIL,20000000,12987647,26348203,39335850
2002,The Ring,PASS,48000000,129094024,248218486,377312510
2002,The Rules of Attraction,FAIL,4000000,6525762,11799060,18324822
2002,The Santa Clause 2,FAIL,65000000,139225854,172825854,312051708
2002,The Sweetest Thing,PASS,43000000,24430272,44633441,69063713
2002,The Transporter,FAIL,21000000,25296447,43928932,69225379
2002,The Tuxedo,FAIL,60000000,50586000,104429625,155015625
2002,Treasure Planet,FAIL,100000000,38120554,91800000,129920554
2002,Tuck Everlasting,PASS,15000000,19161999,19344615,38506614
2002,Two Weeks Notice,PASS,60000000,93354918,199043309,292398227
2002,We Were Soldiers,PASS,70000000,78120196,114658262,192778458
2002,Whale Rider,PASS,4300000,20779666,39892476,60672142
2002,White Oleander,PASS,16000000,16357770,21657770,38015540
2002,xXx,FAIL,70000000,141930000,267200000,409130000
2001,A Beautiful Mind,FAIL,78000000,170708996,317668058,488377054
2001,A Knight&#39;s Tale,FAIL,41000000,56083966,100622586,156706552
2001,Along Came A Spider,PASS,28000000,74058698,105159085,179217783
2001,American Outlaws,FAIL,35000000,13264986,13264986,26529972
2001,Antitrust,FAIL,30000000,10965209,17865209,28830418
2001,Artificial Intelligence: AI,FAIL,90000000,78616689,235900000,314516689
2001,Atlantis: The Lost Empire,FAIL,90000000,84052762,186049020,270101782
2001,Black Hawk Down,FAIL,95000000,108638745,159691085,268329830
2001,Blow,FAIL,30000000,52990775,83282296,136273071
2001,Bridget Jones&#39;s Diary,PASS,25000000,71500556,281527158,353027714
2001,Don&#39;t Say A Word,PASS,50000000,54997476,104488383,159485859
2001,Donnie Darko,FAIL,4500000,1270522,7696529,8967051
2001,Dr. Dolittle 2,PASS,72000000,112950721,176101721,289052442
2001,Evolution,PASS,80000000,38311134,98341932,136653066
2001,From Hell,FAIL,35000000,31598308,68712365,100310673
2001,Ghost World,PASS,5500000,6217849,8761608,14979457
2001,Gosford Park,PASS,18000000,41300105,41300105,82600210
2001,Hannibal,PASS,87000000,165092266,350100280,515192546
2001,Harry Potter and the Sorcerer&#39;s Stone,PASS,125000000,317575550,974755371,1292330921
2001,Hedwig and the Angry Inch,PASS,6000000,3067312,3643900,6711212
2001,High Heels and Low Lifes,PASS,10000000,226792,226792,453584
2001,Impostor,FAIL,40000000,6114237,6114237,12228474
2001,Jason X,PASS,14000000,13121555,16951798,30073353
2001,Jay and Silent Bob Strike Back,PASS,22000000,30059386,33762400,63821786
2001,Jeepers Creepers,PASS,10000000,37904175,58939035,96843210
2001,Josie and the Pussycats,PASS,22000000,14252830,14252830,28505660
2001,Kate &amp; Leopold,FAIL,48000000,47095453,70937778,118033231
2001,Kiss of the Dragon,FAIL,25000000,36833473,36833473,73666946
2001,Kissing Jessica Stein,PASS,1500000,7025722,8831884,15857606
2001,L.I.E.,FAIL,700000,1140965,1140965,2281930
2001,Lara Croft: Tomb Raider,FAIL,94000000,131144183,274644183,405788366
2001,Legally Blonde,PASS,18000000,96493426,141809235,238302661
2001,Lovely and Amazing,PASS,250000,4210379,4695781,8906160
2001,Monkeybone,FAIL,75000000,5409517,5409517,10819034
2001,Monsoon Wedding,PASS,1200000,13876974,27025600,40902574
2001,"Monsters, Inc.",FAIL,115000000,289423425,559757719,849181144
2001,Moulin Rouge!,PASS,53000000,57386369,179213196,236599565
2001,Mulholland Dr.,PASS,15000000,7219578,11919578,19139156
2001,Nowhere in Africa,PASS,6500000,6173485,6173485,12346970
2001,Ocean&#39;s Eleven,FAIL,85000000,183417150,450728529,634145679
2001,Osmosis Jones,FAIL,70000000,13596911,13596911,27193822
2001,Pearl Harbor,FAIL,151500000,198539855,449239855,647779710
2001,Save the Last Dance,PASS,13000000,91038276,131638276,222676552
2001,Shallow Hal,PASS,40000000,70836296,70836296,141672592
2001,Shaolin Soccer,FAIL,10000000,488872,42776032,43264904
2001,Shrek,FAIL,50000000,267655011,491812794,759467805
2001,Someone Like You...,PASS,23000000,27338033,38684906,66022939
2001,Spy Kids,PASS,35000000,112692062,197692062,310384124
2001,Super Troopers,FAIL,3000000,18492362,23046142,41538504
2001,The Fast and the Furious,FAIL,38000000,144512310,206512310,351024620
2001,The Glass House,PASS,22000000,17951431,22861785,40813216
2001,The Legend of Suriyothai,PASS,9000000,454255,454255,908510
2001,The Lord of the Rings: The Fellowship of the Ring,FAIL,109000000,315544750,887217688,1202762438
2001,The Majestic,FAIL,72000000,27796042,37306334,65102376
2001,The One,FAIL,49000000,43905746,43905746,87811492
2001,The Others,PASS,17000000,96522687,209947037,306469724
2001,The Princess Diaries,PASS,30000000,108244774,165334774,273579548
2001,The Royal Tenenbaums,PASS,28000000,52353636,71430876,123784512
2001,The Wedding Planner,PASS,28000000,60400856,94728529,155129385
2001,Thir13en Ghosts,FAIL,19000000,41867960,68467960,110335920
2001,Training Day,FAIL,45000000,76261036,104505362,180766398
2001,Valentine,FAIL,10000000,20384136,20384136,40768272
2001,Vanilla Sky,FAIL,70000000,100614858,202726605,303341463
2001,Zoolander,PASS,28000000,45172250,60780981,105953231
2000,28 Days,PASS,43000000,37035515,62063972,99099487
2000,Almost Famous,PASS,60000000,32522352,47371191,79893543
2000,American Psycho,FAIL,8000000,15070285,28674417,43744702
2000,Beautiful Creatures,PASS,50000000,19452138,55940671,75392809
2000,Best in Show,PASS,6000000,18621249,20695413,39316662
2000,Billy Elliot,PASS,5000000,21995263,109280263,131275526
2000,Boiler Room,FAIL,9000000,16963963,28773637,45737600
2000,Bring It On,PASS,10000000,68353550,90453550,158807100
2000,Cast Away,FAIL,85000000,233632142,427230516,660862658
2000,Cecil B. Demented,PASS,10000000,1276984,1953882,3230866
2000,Center Stage,PASS,18000000,17200925,17200925,34401850
2000,Charlie&#39;s Angels,PASS,90000000,125305545,259736090,385041635
2000,Chicken Run,PASS,42000000,106793915,227793915,334587830
2000,Chocolat,PASS,25000000,71309760,152500343,223810103
2000,Coyote Ugly,FAIL,45000000,60786269,115786269,176572538
2000,Dancer in the Dark,PASS,12500000,4157491,45557491,49714982
2000,"Dude, Where&#39;s My Car",FAIL,14000000,46729374,73180297,119909671
2000,Dune,PASS,45000000,27447471,27447471,54894942
2000,Erin Brockovich,PASS,50000000,125548685,257805243,383353928
2000,Final Destination,FAIL,23000000,53302314,112036870,165339184
2000,Gladiator,FAIL,103000000,187683805,457683805,645367610
2000,Gone in Sixty Seconds,FAIL,103300000,101643008,232643008,334286016
2000,High Fidelity,FAIL,20000000,27277055,47881663,75158718
2000,Hollow Man,PASS,90000000,73209340,191200000,264409340
2000,Little Nicky,FAIL,80000000,39442871,58270391,97713262
2000,Love &amp; Basketball,PASS,15000000,27441122,27709625,55150747
2000,Meet the Parents,FAIL,55000000,166225040,304599899,470824939
2000,Memento,FAIL,5000000,25544867,39723096,65267963
2000,Miss Congeniality,PASS,45000000,106807667,213420951,320228618
2000,Mission to Mars,FAIL,90000000,60874615,106000000,166874615
2000,"O Brother, Where Art Thou?",FAIL,26000000,45506619,75763814,121270433
2000,Pitch Black,PASS,23000000,39235088,53182088,92417176
2000,Pokemon: The Movie 2000,FAIL,30000000,43746923,133946923,177693846
2000,Red Planet,FAIL,80000000,17480890,33463969,50944859
2000,Remember the Titans,FAIL,30000000,115654751,136706683,252361434
2000,Requiem for a Dream,PASS,4500000,3635482,7390108,11025590
2000,Return to Me,FAIL,24000000,32662299,32662299,65324598
2000,Romeo Must Die,FAIL,25000000,55973336,91036760,147010096
2000,Rugrats in Paris:,PASS,30000000,76501438,103284813,179786251
2000,Saving Grace,PASS,4000000,12178602,27786849,39965451
2000,Scream 3,PASS,40000000,89138076,161838076,250976152
2000,Sexy Beast,FAIL,4300000,6946056,10154577,17100633
2000,Shanghai Noon,FAIL,55000000,56932305,71189835,128122140
2000,Snatch.,FAIL,10000000,30093107,83593107,113686214
2000,Songcatcher,PASS,1800000,3050934,3050934,6101868
2000,The Beach,FAIL,50000000,39778599,39778599,79557198
2000,The Cell,FAIL,35000000,61280963,85911226,147192189
2000,The Emperor&#39;s New Groove,PASS,100000000,89296573,169296573,258593146
2000,The Gift,FAIL,10000000,12008642,44567606,56576248
2000,The Patriot,FAIL,110000000,113330342,215300000,328630342
2000,The Road to El Dorado,FAIL,95000000,50802661,65700000,116502661
2000,The Way of the Gun,FAIL,9000000,6047856,13061935,19109791
2000,The Whole Nine Yards,PASS,24000000,57262492,85527867,142790359
2000,Thirteen days,FAIL,80000000,34566746,66554547,101121293
2000,Titan A.E.,PASS,75000000,22751979,36751979,59503958
2000,Unbreakable,FAIL,73243106,94999143,248099143,343098286
2000,Urbania,FAIL,225000,1032075,1032075,2064150
2000,Vertical Limit,FAIL,75000000,68473360,213500000,281973360
2000,What Lies Beneath,PASS,90000000,155464351,288693989,444158340
2000,What Women Want,FAIL,65000000,182805123,372100000,554905123
2000,Where the Heart Is,PASS,15000000,33771174,40862054,74633228
2000,"Wo hu cang long (Crouching Tiger, Hidden Dragon)",PASS,15000000,128067808,213200000,341267808
2000,X-Men,FAIL,75000000,157299717,296339717,453639434
1999,10 Things I Hate About You,PASS,13000000,38177966,60414025,98591991
1999,8MM,FAIL,40000000,36443442,96398826,132842268
1999,American Beauty,PASS,15000000,130058047,356258047,486316094
1999,American Pie,FAIL,12000000,101800948,234723148,336524096
1999,Analyze This,FAIL,30000000,106885658,176885658,283771316
1999,Anna and the King,FAIL,75000000,39251128,39251128,78502256
1999,Anywhere But Here,FAIL,23000000,18653615,18653615,37307230
1999,Austin Powers: The Spy Who Shagged Me,FAIL,35000000,206040085,310332636,516372721
1999,Being John Malkovich,PASS,13000000,22858926,32382381,55241307
1999,Black and White,PASS,10000000,5241315,5241315,10482630
1999,Blue Streak,FAIL,36000000,68208190,117448157,185656347
1999,Boys Don&#39;t Cry,PASS,2000000,11540607,20741000,32281607
1999,But I&#39;m a Cheerleader,PASS,1200000,2205627,2629191,4834818
1999,Carrie 2: The Rage,PASS,21000000,17760244,17760244,35520488
1999,Cruel Intentions,PASS,11000000,38230075,75803716,114033791
1999,Dick,PASS,13000000,6276869,6276869,12553738
1999,Dogma,FAIL,10000000,30651422,43948865,74600287
1999,Drop Dead Gorgeous,PASS,10000000,10571408,10571408,21142816
1999,Election,PASS,8500000,14943582,17202854,32146436
1999,Eyes Wide Shut,PASS,65000000,55691208,86257553,141948761
1999,Fight Club,FAIL,65000000,37030102,100853753,137883855
1999,Flawless,FAIL,27000000,4485485,4485485,8970970
1999,For Love of the Game,FAIL,50000000,35188640,46112640,81301280
1999,Galaxy Quest,FAIL,45000000,71423726,90523726,161947452
1999,"Girl, Interrupted",PASS,24000000,28871190,28871190,57742380
1999,Go!,PASS,6500000,16875273,28383441,45258714
1999,Jawbreaker,PASS,3000000,3076820,3076820,6153640
1999,Magnolia,FAIL,37000000,22450975,48446802,70897777
1999,Muppets From Space,PASS,24000000,16304786,16304786,32609572
1999,Mystery Men,FAIL,68000000,29762011,33462011,63224022
1999,Notting Hill,PASS,42000000,116089678,363728226,479817904
1999,Office Space,FAIL,10000000,10827813,12827813,23655626
1999,Payback,FAIL,50000000,81526121,161626121,243152242
1999,Pocket Monsters: Mewtwo Strikes Back!,FAIL,30000000,85744662,163644662,249389324
1999,Ravenous,FAIL,12000000,2062406,2062406,4124812
1999,Sleepy Hollow,PASS,70000000,101068340,207068340,308136680
1999,South Park: Bigger Longer &amp; Uncut,FAIL,21000000,52037603,52037603,104075206
1999,Star Wars: Episode I - The Phantom Menace,PASS,115000000,474544677,1007044677,1481589354
1999,Stuart Little,FAIL,105000000,140015224,298800000,438815224
1999,Tarzan,FAIL,145000000,171091819,448191819,619283638
1999,The 13th Warrior,FAIL,125000000,32698899,61698899,94397798
1999,The Blair Witch Project,PASS,600000,140539099,248300000,388839099
1999,The Boondock Saints,FAIL,7000000,30471,411874,442345
1999,The Green Mile,FAIL,60000000,136801374,290701374,427502748
1999,The Haunting,PASS,80000000,91188905,180188905,271377810
1999,The Iron Giant,FAIL,50000000,23159305,31333917,54493222
1999,The Matrix,PASS,65000000,171479930,460279930,631759860
1999,The Mummy,FAIL,80000000,155385488,416385488,571770976
1999,The Sixth Sense,FAIL,40000000,293506292,672806292,966312584
1999,The Talented Mr. Ripley,FAIL,40000000,81292135,128792135,210084270
1999,Three to Tango,FAIL,20000000,10570375,10570375,21140750
1999,Topsy-Turvy,PASS,20000000,6201757,6201757,12403514
1999,Toy Story 2,FAIL,90000000,245852179,511358276,757210455
1999,Virus,FAIL,75000000,14010690,30626690,44637380
1999,Wild Wild West,FAIL,175000000,113805681,221229335,335035016
1999,Wing Commander,FAIL,30000000,11578022,11578022,23156044
1998,54,FAIL,13000000,16757163,16757163,33514326
1998,A Bug&#39;s Life,PASS,45000000,162798565,363095319,525893884
1998,American History X,FAIL,10000000,6719864,6719864,13439728
1998,Armageddon,FAIL,140000000,201578182,554600000,756178182
1998,Beloved,PASS,53000000,22852487,22852487,45704974
1998,Blade,FAIL,45000000,70141876,131237688,201379564
1998,Bride of Chucky,FAIL,25000000,32404188,50692188,83096376
1998,Buffalo &#39;66,FAIL,1500000,2380606,2380606,4761212
1998,Dark City,FAIL,27000000,14435076,27257061,41692137
1998,Deep Impact,PASS,80000000,140464664,349464664,489929328
1998,Disturbing Behavior,FAIL,15000000,17507368,17507368,35014736
1998,Elizabeth,PASS,25000000,30082699,82150642,112233341
1998,Enemy of the State,FAIL,85000000,111549836,250649836,362199672
1998,Ever After,PASS,26000000,65705772,65705772,131411544
1998,Fear and Loathing in Las Vegas,FAIL,18500000,10680275,13711903,24392178
1998,Festen (The Celebration),FAIL,1300000,1647780,1647780,3295560
1998,Get Real,FAIL,2000000,1152411,1152411,2304822
1998,Godzilla,FAIL,125000000,136314294,376000000,512314294
1998,Halloween H20: 20 Years Later,PASS,17000000,55041738,55041738,110083476
1998,Happiness,PASS,3000000,2746453,5746453,8492906
1998,Hope Floats,PASS,30000000,60110313,81529000,141639313
1998,Little Voice,PASS,6000000,4595000,21787233,26382233
1998,"Lock, Stock and Two Smoking Barrels",FAIL,1350000,3897569,28356188,32253757
1998,Lost in Space,PASS,80000000,69117629,136047317,205164946
1998,Mercury Rising,FAIL,60000000,32983332,32983332,65966664
1998,Mulan,FAIL,90000000,120620254,303500000,424120254
1998,Out of Sight,FAIL,48000000,37562568,77562568,115125136
1998,Pi,FAIL,68000,3221152,4678513,7899665
1998,Practical Magic,PASS,60000000,46850558,68336997,115187555
1998,Primary Colors,PASS,65000000,39017984,39017984,78035968
1998,Quest for Camelot,PASS,40000000,22772500,38172500,60945000
1998,Rounders,FAIL,12000000,22921898,22921898,45843796
1998,Run Lola Run,FAIL,1750000,7267324,14533173,21800497
1998,Rush Hour,PASS,35000000,141186864,245300000,386486864
1998,Rushmore,FAIL,10000000,17105219,19080435,36185654
1998,Safe Men,FAIL,1000000,21210,21210,42420
1998,Saving Private Ryan,FAIL,65000000,216335085,485035085,701370170
1998,Shakespeare in Love,PASS,26000000,100317794,279500000,379817794
1998,Six Days Seven Nights,FAIL,80000000,74339294,164800000,239139294
1998,Sliding Doors,PASS,6000000,11911200,58809149,70720349
1998,Slums of Beverly Hills,PASS,5000000,5502773,5502773,11005546
1998,Small Soldiers,FAIL,40000000,55143823,71743823,126887646
1998,Smoke Signals,PASS,2000000,6719300,7756617,14475917
1998,Sphere,FAIL,73000000,37068294,50168294,87236588
1998,Star Trek: Insurrection,PASS,70000000,70187658,117800000,187987658
1998,Stepmom,PASS,50000000,91137662,159745279,250882941
1998,The Avengers,PASS,60000000,23385416,48585416,71970832
1998,The Big Lebowski,FAIL,15000000,17498804,46189568,63688372
1998,The Faculty,FAIL,15000000,40283321,40283321,80566642
1998,The Man in the Iron Mask,FAIL,35000000,56968169,56968169,113936338
1998,The Mask of Zorro,FAIL,65000000,93828745,233700000,327528745
1998,The Negotiator,FAIL,50000000,44705766,49105766,93811532
1998,The Prince of Egypt,FAIL,60000000,101413188,218600000,320013188
1998,The Proposition,FAIL,20000000,1903434,5313608,7217042
1998,The Thin Red Line,FAIL,52000000,36400491,36400491,72800982
1998,The Truman Show,FAIL,60000000,125618201,248400000,374018201
1998,There&#39;s Something About Mary,PASS,22000000,176484651,360099999,536584650
1998,Urban Legend,PASS,14000000,38116707,72571864,110688571
1998,Vampires (John Carpenter&#39;s),FAIL,20000000,20268825,20268825,40537650
1998,Velvet Goldmine,FAIL,9000000,1053788,4861972,5915760
1998,Wild Things,FAIL,20000000,29795299,55576699,85371998
1998,You&#39;ve Got Mail,PASS,65000000,115821495,250800000,366621495
1997,A Simple Wish,PASS,28000000,8165213,8165213,16330426
1997,Air Bud,FAIL,3000000,24646936,27788649,52435585
1997,Air Force One,FAIL,85000000,172956409,315268353,488224762
1997,Alien: Resurrection,PASS,60000000,47795018,160700000,208495018
1997,Anastasia,PASS,53000000,58403409,139801410,198204819
1997,As Good as It Gets,PASS,50000000,148478011,314111923,462589934
1997,Austin Powers: International Man of Mystery,FAIL,18000000,53883989,67683989,121567978
1997,Batman &amp; Robin,FAIL,125000000,107325195,238317814,345643009
1997,Boogie Nights,FAIL,15000000,26410771,43111725,69522496
1997,Cats Don&#39;t Dance,PASS,32000000,3588602,3588602,7177204
1997,Chasing Amy,PASS,250000,12006514,15155095,27161609
1997,Cinderella,PASS,2900000,85000000,85000000,170000000
1997,Clockwatchers,PASS,2000000,537948,539961,1077909
1997,Con Air,FAIL,80000000,101117573,224117573,325235146
1997,Conspiracy Theory,FAIL,80000000,76118990,142783718,218902708
1997,Contact,PASS,90000000,100920329,165900000,266820329
1997,Eve&#39;s Bayou,PASS,5000000,14843425,14843425,29686850
1997,Event Horizon,PASS,60000000,26673242,26673242,53346484
1997,Fever Pitch,PASS,40000000,42071069,50071069,92142138
1997,Flubber,FAIL,80000000,92993801,177993801,270987602
1997,G.I. Jane,PASS,50000000,48169156,48169156,96338312
1997,Gattaca,FAIL,36000000,12532777,12532777,25065554
1997,George of the Jungle,PASS,55000000,105263257,174463257,279726514
1997,Good Will Hunting,FAIL,10000000,138433435,225933435,364366870
1997,Grosse Pointe Blank,PASS,15000000,28084357,31070412,59154769
1997,Hercules,PASS,70000000,99112101,250700000,349812101
1997,I Know What You Did Last Summer,PASS,17000000,72250091,125250091,197500182
1997,In the Company of Men,FAIL,25000,2883661,2883661,5767322
1997,Jackie Brown,PASS,12000000,39673162,74727492,114400654
1997,Kiss the Girls,FAIL,27000000,60527873,60527873,121055746
1997,L.A. Confidential,FAIL,35000000,64604977,110604977,175209954
1997,Liar Liar,FAIL,45000000,181410615,302710615,484121230
1997,Men in Black,FAIL,90000000,250690539,587790539,838481078
1997,Mononoke-hime,PASS,20000000,2374107,150350000,152724107
1997,Mortal Kombat: Annihilation,PASS,30000000,35927406,51327406,87254812
1997,Must love Dogs,FAIL,35000000,43894863,58894863,102789726
1997,My Best Friend&#39;s Wedding,FAIL,46000000,126813153,298923419,425736572
1997,Orgazmo,FAIL,1000000,582024,627287,1209311
1997,Scream 2,PASS,24000000,101363301,101363301,202726602
1997,Selena,PASS,20000000,35450113,35450113,70900226
1997,Smilla&#39;s Sense of Snow,PASS,35000000,2221994,2221994,4443988
1997,Spawn,PASS,40000000,54979992,87949859,142929851
1997,Starship Troopers,PASS,100000000,54768952,121100000,175868952
1997,The Devil&#39;s Advocate,PASS,57000000,61007424,153007424,214014848
1997,The Fifth Element,FAIL,95000000,63570862,263900000,327470862
1997,The Game,FAIL,50000000,48265581,48265581,96531162
1997,The Lost World: Jurassic Park,FAIL,75000000,229086679,786686679,1015773358
1997,The Peacemaker,FAIL,50000000,41263140,62967368,104230508
1997,The Postman,FAIL,80000000,17650704,17650704,35301408
1997,Titanic,PASS,200000000,658672302,2185672302,2844344604
1997,Volcano,PASS,90000000,47546796,120100000,167646796
1996,August,FAIL,3400000,12636,12636,25272
1996,Bound,PASS,4500000,3802260,7011317,10813577
1996,Broken Arrow,FAIL,65000000,70645997,148345997,218991994
1996,Chain Reaction,FAIL,55000000,21226204,60209334,81435538
1996,DragonHeart,FAIL,57000000,51364680,104364680,155729360
1996,Emma,PASS,5900000,22231658,37831658,60063316
1996,Escape from L.A.,FAIL,50000000,25426861,25426861,50853722
1996,Eye for an Eye,PASS,20000000,26792700,26792700,53585400
1996,Fargo,PASS,7000000,24567751,51204567,75772318
1996,Freeway,PASS,3000000,295493,295493,590986
1996,From Dusk Till Dawn,FAIL,20000000,25728961,25728961,51457922
1996,Hamlet,FAIL,2000000,1577287,2419669,3996956
1996,Harriet the Spy,PASS,13000000,26570048,26570048,53140096
1996,Independence Day,PASS,75000000,306169255,817400878,1123570133
1996,Jingle All the Way,FAIL,60000000,60592389,129832389,190424778
1996,Kingpin,FAIL,25000000,25023424,32223424,57246848
1996,Love and Other Catastrophes,PASS,250000,212285,743216,955501
1996,Mars Attacks!,PASS,80000000,37771017,101371017,139142034
1996,Mission: Impossible,FAIL,80000000,180981886,457697994,638679880
1996,Romeo + Juliet,FAIL,14500000,46338728,147542381,193881109
1996,Scream,PASS,15000000,103046663,173046663,276093326
1996,Secrets &amp; Lies,PASS,4500000,13417292,13417292,26834584
1996,Set It Off,PASS,9000000,36049108,36049108,72098216
1996,Space Jam,FAIL,80000000,90463534,250200000,340663534
1996,Spy Hard,FAIL,18000000,26936265,26936265,53872530
1996,Star Trek: First Contact,PASS,46000000,92027888,150000000,242027888
1996,Striptease,FAIL,50000000,33109743,113309743,146419486
1996,That Thing You Do!,PASS,2500000,25857416,34557416,60414832
1996,The Cable Guy,FAIL,47000000,60240295,102825796,163066091
1996,The Craft,PASS,15000000,24769466,55669466,80438932
1996,The English Patient,PASS,35000000,78716374,231716374,310432748
1996,The Fan,FAIL,55000000,18582965,18582965,37165930
1996,The First Wives Club,PASS,30000000,105489203,181489203,286978406
1996,The Glimmer Man,FAIL,45000000,20404841,36404841,56809682
1996,The Hunchback of Notre Dame,FAIL,100000000,100138851,325500000,425638851
1996,The Long Kiss Goodnight,FAIL,65000000,33447612,33447612,66895224
1996,The Mirror Has Two Faces,PASS,42000000,41267469,41267469,82534938
1996,The Rock,FAIL,75000000,134069511,336069511,470139022
1996,Trainspotting,FAIL,3100000,16501785,24000785,40502570
1996,Twister,PASS,88000000,241888385,495900000,737788385
1996,Walking and Talking,PASS,1000000,1287480,1615787,2903267
1996,When the Cat&#39;s Away,PASS,300000,1652472,2525984,4178456
1995,Apollo 13,PASS,65000000,172070496,334100000,506170496
1995,Assassins,FAIL,50000000,30306268,83306268,113612536
1995,Batman Forever,FAIL,100000000,184031112,336529144,520560256
1995,Before Sunrise,FAIL,2500000,5274005,5274005,10548010
1995,Braveheart,FAIL,72000000,75545647,209000000,284545647
1995,Casino,FAIL,52000000,42438300,110400000,152838300
1995,Casper,PASS,55000000,100328194,282300000,382628194
1995,Clueless,PASS,13700000,56598476,56598476,113196952
1995,Congo,FAIL,50000000,81022333,152022333,233044666
1995,Copycat,FAIL,20000000,32051917,32051917,64103834
1995,Die Hard: With a Vengeance,FAIL,90000000,100012499,364480746,464493245
1995,Four rooms,FAIL,4000000,4301000,4301000,8602000
1995,Home for the holidays,PASS,20000000,17468887,22119269,39588156
1995,Jumanji,PASS,65000000,100458310,262758310,363216620
1995,Mallrats,FAIL,6100000,2108367,2108367,4216734
1995,Mortal Kombat,FAIL,20000000,70433227,122133227,192566454
1995,Outbreak,PASS,50000000,67823573,67823573,135647146
1995,Pocahontas,PASS,55000000,141579773,347100000,488679773
1995,Pride and Prejudice,PASS,28000000,38372662,120918508,159291170
1995,Sabrina,PASS,58000000,53458319,87100000,140558319
1995,Safe,PASS,33000000,17142080,41495213,58637293
1995,Se7en,FAIL,30000000,100125643,328125643,428251286
1995,Sense and Sensibility,PASS,16500000,42993774,134993774,177987548
1995,Showgirls,PASS,40000000,20350754,37750754,58101508
1995,Species,FAIL,35000000,60054449,113354449,173408898
1995,Tank Girl,PASS,25000000,4064333,4064333,8128666
1995,The American President,PASS,62000000,60022813,107822813,167845626
1995,The Bridges of Madison County,PASS,22000000,71516617,175516617,247033234
1995,The Incredibly True Adventures of Two Girls in Love,PASS,250000,2210408,2477155,4687563
1995,The Net,PASS,22000000,50621733,110521733,161143466
1995,The Quick and the Dead,FAIL,32000000,18552460,18552460,37104920
1995,The Usual Suspects,FAIL,6000000,23341568,34449356,57790924
1995,Toy Story,FAIL,30000000,191780865,364530148,556311013
1995,Twelve Monkeys,FAIL,29000000,57141459,168841459,225982918
1995,Waterworld,FAIL,175000000,88246220,264246220,352492440
1995,Welcome to the Dollhouse,PASS,800000,4198137,5034794,9232931
1994,Ace Ventura: Pet Detective,FAIL,12000000,72217396,107217396,179434792
1994,Beverly Hills Cop III,FAIL,50000000,42586861,119180938,161767799
1994,Clerks.,FAIL,27000,3073428,3894240,6967668
1994,Crooklyn,PASS,14000000,13024170,13024170,26048340
1994,Dumb &amp; Dumber,FAIL,16000000,127175374,246400000,373575374
1994,Ed Wood,PASS,18000000,5828466,5828466,11656932
1994,Forrest Gump,FAIL,55000000,329694499,679400525,1009095024
1994,Legends of the Fall,PASS,30000000,66502573,160502573,227005146
1994,Little Women,PASS,15000000,50003303,50003303,100006606
1994,Naked Gun 33 1/3: The Final Insult,FAIL,30000000,51041856,51041856,102083712
1994,Police Academy: Mission to Moscow,FAIL,10000000,126247,126247,252494
1994,Priest,PASS,60000000,29136626,84154026,113290652
1994,Pulp Fiction,PASS,8000000,107928762,212928762,320857524
1994,Speed,PASS,30000000,121248145,283200000,404448145
1994,Stargate,FAIL,55000000,71565669,196565669,268131338
1994,Street Fighter,PASS,35000000,33423000,99423000,132846000
1994,The Client,PASS,45000000,92115211,117615211,209730422
1994,The Hudsucker Proxy,FAIL,40000000,2816518,14938149,17754667
1994,The Lion King,FAIL,79300000,422780140,952880140,1375660280
1994,The Mask,FAIL,18000000,119920129,351620129,471540258
1994,The Santa Clause,FAIL,22000000,144833357,189800000,334633357
1994,The Shadow,FAIL,40000000,31835600,31835600,63671200
1994,The Shawshank Redemption,FAIL,25000000,28241469,28241469,56482938
1994,The Specialist,FAIL,45000000,57362581,57362581,114725162
1994,Timecop,FAIL,28000000,44853581,102053581,146907162
1994,True Lies,FAIL,100000000,146282411,365300000,511582411
1993,Cliffhanger,FAIL,65000000,84049211,255000000,339049211
1993,Cool Runnings,FAIL,14000000,68856263,155056263,223912526
1993,Dazed and Confused,PASS,6900000,7950889,7950889,15901778
1993,Gettysburg,FAIL,25000000,10731997,10731997,21463994
1993,Groundhog Day,FAIL,14600000,70906973,70906973,141813946
1993,Hocus Pocus,PASS,28000000,39360491,39360491,78720982
1993,Jurassic Park,PASS,63000000,395708305,1035626872,1431335177
1993,Mrs. Doubtfire,PASS,25000000,219195051,441286003,660481054
1993,Pieces of April,PASS,300000,2528664,3590570,6119234
1993,Schindler&#39;s List,PASS,25000000,96067179,321365567,417432746
1993,Super Mario Bros.,FAIL,42000000,20844907,20844907,41689814
1993,The Age of Innocence,PASS,34000000,32014993,32014993,64029986
1993,The Fugitive,FAIL,44000000,183875760,353715317,537591077
1993,The Princess and the Cobbler,FAIL,24000000,669276,669276,1338552
1993,The Remains of the Day,FAIL,15000000,22954968,63954968,86909936
1993,Tombstone,PASS,25000000,56505065,56505065,113010130
1992,A Few Good Men,FAIL,33000000,141340178,236500000,377840178
1992,A League of Their Own,PASS,40000000,107533925,132440066,239973991
1992,Aladdin,FAIL,28000000,217350219,504050219,721400438
1992,Alien 3,FAIL,55000000,54927174,158500000,213427174
1992,Army of Darkness,FAIL,11000000,11502976,21502976,33005952
1992,Batman Returns,FAIL,80000000,162833635,266824291,429657926
1992,Buffy the Vampire Slayer,PASS,7000000,14231669,14231669,28463338
1992,Death Becomes Her,PASS,55000000,58422650,149022650,207445300
1992,El Mariachi,FAIL,7000,2040920,2041928,4082848
1992,Glengarry Glen Ross,FAIL,12500000,10725228,10725228,21450456
1992,Hero,FAIL,42000000,19487173,66787173,86274346
1992,Home Alone 2: Lost in New York,FAIL,20000000,173585516,358994850,532580366
1992,Malcolm X,FAIL,35000000,48169910,48169910,96339820
1992,My Cousin Vinny,FAIL,11000000,52929168,52929168,105858336
1992,Reservoir Dogs,FAIL,1200000,2832029,2832029,5664058
1992,The Crying Game,FAIL,4000000,62546695,62546695,125093390
1992,The Mighty Ducks,FAIL,10000000,50752337,50752337,101504674
1992,The Muppet Christmas Carol,FAIL,12000000,27281507,27281507,54563014
1992,The Player,PASS,8000000,21706101,28876702,50582803
1992,Wayne&#39;s World,FAIL,20000000,121697323,183097323,304794646
1991,Beauty and the Beast,PASS,20000000,218951625,451421625,670373250
1991,Bill &amp; Ted&#39;s Bogus Journey,FAIL,20000000,37537675,37537675,75075350
1991,Hook,FAIL,70000000,119654823,300854823,420509646
1991,Hudson Hawk,PASS,65000000,17218916,17218916,34437832
1991,Robin Hood: Prince of Thieves,FAIL,50000000,165493908,390500000,555993908
1991,Slacker,PASS,23000,1227508,1227508,2455016
1991,Star Trek VI: The Undiscovered Country,FAIL,27000000,74888996,96900000,171788996
1991,Teenage Mutant Ninja Turtles II: The Secret of the Ooze,PASS,25000000,78656813,78656813,157313626
1991,Terminator 2: Judgement Day,FAIL,100000000,204859496,516816151,721675647
1991,The Addams Family,PASS,30000000,113502246,191502246,305004492
1991,The Naked Gun 2 1/2: The Smell of Fear,FAIL,23000000,86930411,86930411,173860822
1991,The Silence of the Lambs,PASS,20000000,130726716,275726716,406453432
1991,White Fang,FAIL,14000000,34729091,34729091,69458182
1990,Back to the Future Part III,FAIL,40000000,87666629,243700000,331366629
1990,Child&#39;s Play 2,PASS,13000000,26904572,34166572,61071144
1990,Dark Angel (I Come in Peace),FAIL,7000000,4372561,4372561,8745122
1990,Die Hard 2,FAIL,70000000,117323878,239814025,357137903
1990,Edward Scissorhands,PASS,20000000,53976987,53976987,107953974
1990,Flatliners,PASS,26000000,61308153,61308153,122616306
1990,Ghost,FAIL,22000000,217631306,517600000,735231306
1990,Goodfellas,FAIL,25000000,46743809,46743809,93487618
1990,Home Alone,FAIL,15000000,285761243,476684675,762445918
1990,Nikita,PASS,7000000,5017971,5017971,10035942
1990,Predator 2,FAIL,35000000,28317513,54768418,83085931
1990,Pretty Woman,PASS,14000000,178406268,432645872,611052140
1990,The Hunt for Red October,FAIL,30000000,120709866,200500000,321209866
1990,Total Recall,FAIL,125000000,58877969,198615996,257493965
1990,Tremors,PASS,10000000,16667084,16667084,33334168
1989,Back to the Future Part II,PASS,40000000,118450002,332000000,450450002
1989,Batman,FAIL,35000000,251188924,411348924,662537848
1989,Bill &amp; Ted&#39;s Excellent Adventure,FAIL,10000000,40485039,40485039,80970078
1989,Dead Poets Society,FAIL,16400000,95860116,239500000,335360116
1989,Henry V,PASS,9000000,10161099,10161099,20322198
1989,Indiana Jones and the Last Crusade,FAIL,48000000,197171806,474171806,671343612
1989,Licence to Kill,FAIL,42000000,34667015,156167015,190834030
1989,Major League,FAIL,11000000,49793054,49793054,99586108
1989,Road House,FAIL,10000000,30050028,30050028,60100056
1989,"Sex, Lies, and Videotape",FAIL,1200000,24741667,36741667,61483334
1989,Star Trek V: The Final Frontier,FAIL,30000000,52210049,70200000,122410049
1989,The Abyss,PASS,70000000,54243125,54243125,108486250
1989,Troop Beverly Hills,PASS,18000000,7190505,7190505,14381010
1989,UHF,FAIL,5000000,6157157,6157157,12314314
1988,Action Jackson,FAIL,7000000,20257000,20257000,40514000
1988,Akira,FAIL,8000000,19585,19585,39170
1988,Beetle Juice,PASS,15000000,73326666,73326666,146653332
1988,Bloodsport,FAIL,1500000,11806119,11806119,23612238
1988,Child&#39;s Play,PASS,9000000,33244684,44196684,77441368
1988,Dangerous Liaisons,PASS,14000000,34700000,34700000,69400000
1988,Die Hard,PASS,28000000,81350242,139109346,220459588
1988,Midnight Run,FAIL,30000000,38413606,81613606,120027212
1988,My Stepmother Is an Alien,PASS,16000000,13854000,13854000,27708000
1988,Mystic Pizza,PASS,6000000,12793213,12793213,25586426
1988,Poltergeist III,PASS,9500000,14114000,14114000,28228000
1988,Rain Man,FAIL,25000000,172825435,412800000,585625435
1988,Scrooged,PASS,32000000,60328558,60328558,120657116
1988,The Land Before Time,PASS,12300000,48092846,81972846,130065692
1988,The Last Temptation of Christ,FAIL,7000000,8373585,8373585,16747170
1988,They Live,FAIL,4000000,13000000,13000000,26000000
1988,Twins,FAIL,15000000,111936388,216600000,328536388
1988,Who Framed Roger Rabbit,FAIL,70000000,154112492,351500000,505612492
1988,Young Guns,FAIL,13000000,44726644,44726644,89453288
1987,Beverly Hills Cop II,FAIL,20000000,153665036,276665036,430330072
1987,Evil Dead II,FAIL,3500000,5923044,5923044,11846088
1987,Fatal Attraction,FAIL,14000000,156645693,320100000,476745693
1987,"Good Morning, Vietnam",FAIL,13000000,123922370,123922370,247844740
1987,Hellraiser,PASS,1000000,14564000,14564000,29128000
1987,Lethal Weapon,FAIL,15000000,65192350,120192350,185384700
1987,Predator,FAIL,18000000,59735548,98267558,158003106
1987,Radio Days,FAIL,16000000,14792779,14792779,29585558
1987,RoboCop,FAIL,120000000,54764805,221577330,276342135
1987,Spaceballs,FAIL,22700000,38119483,38119483,76238966
1987,Superman IV: The Quest for Peace,PASS,17000000,11227824,11227824,22455648
1987,The Last Emperor,FAIL,25000000,43984000,43984000,87968000
1987,The Lost Boys,FAIL,8500000,32222567,32222567,64445134
1987,The Princess Bride,FAIL,15000000,30857000,30857000,61714000
1986,Aliens,PASS,17000000,85160248,183316455,268476703
1986,Crocodile Dundee,FAIL,5000000,174803506,328000000,502803506
1986,Highlander,PASS,16000000,5900000,12900000,18800000
1986,Howard The Duck,FAIL,30000000,16295774,16295774,32591548
1986,Little Shop of Horrors,FAIL,30000000,38747385,38747385,77494770
1986,Peggy Sue Got Married,PASS,18000000,41382841,41382841,82765682
1986,Platoon,FAIL,6000000,137963328,137963328,275926656
1986,Stand By Me,FAIL,8000000,52287414,52287414,104574828
1986,The Clan of the Cave Bear,PASS,15000000,1953732,1953732,3907464
1986,Top Gun,FAIL,15000000,179800601,356800601,536601202
1985,Back to the Future,FAIL,19000000,210609762,383874862,594484624
1985,Brazil,PASS,15000000,9929135,9929135,19858270
1985,Commando,FAIL,10000000,35073978,35073978,70147956
1985,Day of the Dead,FAIL,18000000,N/A,N/A,#VALUE!
1985,Ladyhawke,FAIL,20000000,18400000,18400000,36800000
1985,Legend,FAIL,25000000,15502112,15502112,31004224
1985,My Beautiful Laundrette,FAIL,400000,N/A,N/A,#VALUE!
1985,Red Sonja,PASS,17900000,6905861,6905861,13811722
1985,Return to Oz,PASS,27000000,10618813,10618813,21237626
1985,The Color Purple,PASS,15000000,93589701,93589701,187179402
1984,A nightmare on Elm Street,FAIL,35000000,63075011,117729621,180804632
1984,Amadeus,PASS,18000000,51973029,51973029,103946058
1984,Beverly Hills Cop,FAIL,15000000,234760478,316300000,551060478
1984,Body Double,FAIL,10000000,8801940,8801940,17603880
1984,Conan the Destroyer,FAIL,18000000,26400000,26400000,52800000
1984,Dune,FAIL,45000000,27447471,27447471,54894942
1984,Friday the 13th Part IV: The Final Chapter,PASS,2600000,32980880,32980880,65961760
1984,Ghostbusters,FAIL,30000000,238632124,291632124,530264248
1984,Gremlins,FAIL,11000000,148168459,148168459,296336918
1984,Indiana Jones and the Temple of Doom,FAIL,28000000,179880271,333080271,512960542
1984,Police Academy,FAIL,4500000,81198894,81198894,162397788
1984,Repo Man,FAIL,1500000,2300000,2300000,4600000
1984,Splash,FAIL,8000000,62599495,62599495,125198990
1984,Star Trek III: The Search for Spock,FAIL,18000000,76471046,87000000,163471046
1984,The Karate Kid,PASS,40000000,176591618,359091618,535683236
1984,The Terminator,FAIL,6400000,38019031,78019031,116038062
1983,Flashdance,PASS,7000000,90463574,201463574,291927148
1983,Star Wars: Episode VI - Return of the Jedi,FAIL,32500000,309205079,572700000,881905079
1983,Superman III,PASS,39000000,59950623,59950623,119901246
1983,Videodrome,FAIL,5952000,2120439,2120439,4240878
1983,WarGames,FAIL,12000000,74433837,74433837,148867674
1982,Blade Runner,FAIL,28000000,32656328,33139618,65795946
1982,Cat People,PASS,12500000,7000000,21000000,28000000
1982,Conan the Barbarian,FAIL,20000000,38264085,79114085,117378170
1982,Diner,FAIL,5000000,12592907,12592907,25185814
1982,E.T.: The Extra-Terrestrial,FAIL,10500000,435110554,792965326,1228075880
1982,Fast Times at Ridgemont High,FAIL,4500000,27092880,27092880,54185760
1982,First Blood,FAIL,14000000,47212904,125212904,172425808
1982,Friday the 13th Part III,FAIL,2250000,36690067,36690067,73380134
1982,Poltergeist,PASS,10700000,74706019,121706019,196412038
1982,Porky&#39;s,FAIL,4000000,109492484,109492484,218984968
1982,Star Trek: The Wrath of Khan,FAIL,12000000,79912963,96800000,176712963
1982,The Best Little Whorehouse in Texas,PASS,20500000,69701637,69701637,139403274
1982,Tootsie,FAIL,15000000,177200000,177200000,354400000
1982,TRON,FAIL,17000000,26918576,26918576,53837152
1981,Das Boot,FAIL,12000000,11487676,84970337,96458013
1981,Escape from New York,FAIL,6000000,25244700,25244700,50489400
1981,Friday the 13th Part 2,FAIL,1250000,21722776,21722776,43445552
1981,Halloween II,PASS,2500000,25533818,25533818,51067636
1981,Heavy Metal,FAIL,9300000,19571091,19571091,39142182
1981,History of the World: Part I,FAIL,11000000,31672000,31672000,63344000
1981,Raiders of the Lost Ark,FAIL,20000000,248159971,389925971,638085942
1981,The Evil Dead,FAIL,375000,2400000,29400000,31800000
1981,Time Bandits,FAIL,12000000,37400000,37400000,74800000
1980,Airplane!,FAIL,3500000,83453539,83453539,166907078
1980,Can&#39;t Stop the Music,PASS,20000000,2000000,2000000,4000000
1980,Fame,PASS,18000000,22455510,77956957,100412467
1980,Flash Gordon,FAIL,35000000,27107960,27107960,54215920
1980,Friday the 13th,FAIL,17000000,65002019,91700771,156702790
1980,Heaven&#39;s Gate,FAIL,44000000,3484331,3484331,6968662
1980,Private Benjamin,PASS,15000000,69847348,69847348,139694696
1980,Raging Bull,FAIL,18000000,23380203,23380203,46760406
1980,Somewhere in Time,FAIL,5100000,9709597,9709597,19419194
1980,Star Wars: Episode V - The Empire Strikes Back,FAIL,23000000,290271960,534171960,824443920
1980,Superman II,FAIL,54000000,108185706,108185706,216371412
1980,The Blues Brothers,FAIL,27000000,57229890,57229890,114459780
1980,The Fog,PASS,18000000,29511112,37048526,66559638
1980,The Shining,FAIL,19000000,44017374,44017374,88034748
1979,Alien,PASS,9000000,80930630,203630630,284561260
1979,Apocalypse Now,FAIL,31500000,78800000,78800000,157600000
1979,Moonraker,FAIL,31000000,70300000,210300000,280600000
1979,Star Trek: The Motion Picture,FAIL,35000000,82258456,139000000,221258456
1979,The Amityville Horror,PASS,18500000,65233369,109175673,174409042
1978,Animal House,FAIL,3000000,141600000,141600000,283200000
1978,Dawn of the Dead,FAIL,28000000,58990765,103452875,162443640
1978,Days of Heaven,PASS,3000000,3446749,3660880,7107629
1978,Grease,PASS,6000000,181813770,387513770,569327540
1978,Halloween,FAIL,15000000,58269151,77514401,135783552
1978,I Spit on Your Grave,FAIL,1750000,93051,1278471,1371522
1978,Superman,FAIL,55000000,134218018,300200000,434418018
1978,The Deer Hunter,FAIL,15000000,50000000,50000000,100000000
1977,A Bridge Too Far,FAIL,26000000,50800000,50800000,101600000
1977,Annie Hall,PASS,4000000,38251425,38251425,76502850
1977,Close Encounters of the Third Kind,FAIL,20000000,166000000,337700000,503700000
1977,Eraserhead,FAIL,100000,7000000,7000000,14000000
1977,High Anxiety,FAIL,3400000,31063038,31063038,62126076
1977,Julia,PASS,6000000,65108,1365108,1430216
1977,Star Wars,FAIL,11000000,460998007,797900000,1258898007
1976,Assault on Precinct 13,FAIL,30000000,20040895,36040895,56081790
1976,Family Plot,PASS,3000000,13200000,13200000,26400000
1976,Logan&#39;s Run,FAIL,7000000,25000000,25000000,50000000
1976,Network,PASS,3800000,23689877,23689877,47379754
1976,Rocky,FAIL,1000000,117235147,225000000,342235147
1976,Silent Movie,FAIL,4400000,36145695,36145695,72291390
1976,Sparkle,PASS,10000000,24397469,24660323,49057792
1976,Taxi Driver,FAIL,1000000,28262574,28262574,56525148
1975,Barry Lyndon,FAIL,11000000,20000000,20000000,40000000
1975,Jaws,FAIL,12000000,260000000,470700000,730700000
1975,Monty Python and the Holy Grail,FAIL,400000,3427696,5028948,8456644
1975,One Flew Over the Cuckoo&#39;s Nest,FAIL,4400000,108981275,108981275,217962550
1975,The Rocky Horror Picture Show,FAIL,1200000,139876417,139876417,279752834
1974,Black Christmas,PASS,9000000,16235738,16235738,32471476
1974,Blazing Saddles,FAIL,2600000,119500000,119500000,239000000
1974,The Conversation,FAIL,1600000,4420000,4420000,8840000
1974,The Godfather: Part II,PASS,13000000,57300000,57300000,114600000
1974,The Texas Chain Saw Massacre,FAIL,140000,26572439,26572439,53144878
1974,The Towering Inferno,FAIL,140000,26572439,26572439,53144878
1974,Young Frankenstein,FAIL,2800000,86300000,86300000,172600000
1973,American Graffiti,FAIL,777000,115000000,140000000,255000000
1973,High Plains Drifter,FAIL,15700000,15700000,15700000,31400000
1973,Sleeper,FAIL,2000000,18344729,18344729,36689458
1973,The Exorcist,PASS,12000000,204868002,402735134,607603136
1973,The Sting,FAIL,5500000,159616327,159616327,319232654
1972,1776,FAIL,4000000,N/A,N/A,#VALUE!
1972,Pink Flamingos,PASS,12000,413802,413802,827604
1972,The Godfather,FAIL,7000000,134966411,268500000,403466411
1971,Escape from the Planet of the Apes,FAIL,2500000,12300000,12300000,24600000
1971,Shaft,FAIL,53012938,70327868,107190108,177517976
1971,Straw Dogs,FAIL,25000000,10324441,11253821,21578262
1971,The French Connection,FAIL,2200000,41158757,41158757,82317514
1971,Willy Wonka &amp; the Chocolate Factory,FAIL,3000000,4000000,4000000,8000000
1970,Beyond the Valley of the Dolls,PASS,1000000,9000000,9000000,18000000
